"","HSHD_NUM","Spending_2016","Spending_2017","Change","Trend","Spending","Units","Units_2016","Units_2017"
"1",688,2450.23,2739.97,289.74,"increase",5190.2,1922,952,970
"2",2590,1604.04,1312.32,-291.72,"increase",2916.36,1430,744,686
"3",1171,60.05,0,-60.05,"increase",60.05,19,19,0
"4",1531,4038.4,4160.93,122.53,"increase",8199.33,2584,1264,1320
"5",403,2700.97,1987.66,-713.31,"increase",4688.63,2277,1081,1196
"6",283,10904.94,9620.2,-1284.74,"increase",20525.14,7909,4265,3644
"7",3864,9414.91,6855.98,-2558.93,"increase",16270.89,4101,2391,1710
"8",4899,5768.88,4627.49,-1141.39,"increase",10396.37,4104,2298,1806
"9",1443,202.26,0,-202.26,"increase",202.26,42,42,0
"10",3598,3836.13,3409.6,-426.53,"increase",7245.73,2950,1617,1333
"11",3962,6268.57,7275.18,1006.61,"increase",13543.75,5867,2818,3049
"12",556,0,53,53,"increase",53,6,0,6
"13",2932,4617.74,5998.28,1380.54,"increase",10616.02,4397,1774,2623
"14",1580,5489.45,5996.5,507.05,"increase",11485.95,4982,2457,2525
"15",2902,2762.68,2925.13,162.45,"increase",5687.81,1917,847,1070
"16",813,4446.29,5075.68,629.39,"increase",9521.97,3579,1627,1952
"17",986,10792.06,5549.72,-5242.34,"increase",16341.78,5220,3469,1751
"18",1402,546.23,124.34,-421.89,"increase",670.57,246,202,44
"19",3211,0,43.41,43.41,"increase",43.41,21,0,21
"20",535,194.48,75.58,-118.9,"increase",270.06,90,72,18
"21",1021,6643.38,2943.67,-3699.71,"increase",9587.05,3514,2167,1347
"22",1621,1117.99,1232.11,114.12,"increase",2350.1,893,416,477
"23",1937,3319.3,2024.62,-1294.68,"increase",5343.92,1387,957,430
"24",2037,3537.41,1942.95,-1594.46,"increase",5480.36,2277,1458,819
"25",2181,5546.24,5140.23,-406.009999999999,"increase",10686.47,3725,1968,1757
"26",2936,5530.64,6948.51,1417.87,"increase",12479.15,3972,1739,2233
"27",3572,3240.28,3758.2,517.92,"increase",6998.48,1550,667,883
"28",4276,4600.74,4444.32,-156.42,"increase",9045.06,2525,1266,1259
"29",1093,7.38,0,-7.38,"increase",7.38,2,2,0
"30",2377,4673.19,5440.92,767.73,"increase",10114.11,3132,1472,1660
"31",4402,3551.55,4830.11,1278.56,"increase",8381.66,2113,859,1254
"32",4639,3128.05,4539.84,1411.79,"increase",7667.89,3007,1241,1766
"33",1398,0,88.05,88.05,"increase",88.05,27,0,27
"34",3891,7002.72,6327.29,-675.43,"increase",13330.01,3868,2067,1801
"35",4690,0,37.59,37.59,"increase",37.59,21,0,21
"36",4224,5471.45,5896.09,424.64,"increase",11367.54,3423,1730,1693
"37",4842,5569.41,5129.55,-439.86,"increase",10698.96,5836,3098,2738
"38",4843,5569.41,5129.55,-439.86,"increase",10698.96,5836,3098,2738
"39",934,716.88,743.09,26.21,"increase",1459.97,424,189,235
"40",3686,1885.9,3054.66,1168.76,"increase",4940.56,2370,827,1543
"41",4181,1922.66,2717.33,794.67,"increase",4639.99,1861,763,1098
"42",1314,4815.02,5750.04,935.02,"increase",10565.06,3571,1570,2001
"43",2867,6637.29,6530.93,-106.36,"increase",13168.22,7196,3587,3609
"44",2891,2320.8,2773.73,452.93,"increase",5094.53,2210,1154,1056
"45",1499,375.29,543.04,167.75,"increase",918.33,277,86,191
"46",1763,4230.43,2052.52,-2177.91,"increase",6282.95,2224,1463,761
"47",936,3239.97,3401.17,161.2,"increase",6641.14,1966,903,1063
"48",1592,3067.46,2569.24,-498.22,"increase",5636.7,2129,1087,1042
"49",4762,4932.31,11093.61,6161.3,"increase",16025.92,5868,2285,3583
"50",245,32.81,0,-32.81,"increase",32.81,10,10,0
"51",4498,1753.01,1890.99,137.98,"increase",3644,1743,849,894
"52",124,0,44.37,44.37,"increase",44.37,17,0,17
"53",1521,7412.05,7767.56,355.51,"increase",15179.61,6527,3288,3239
"54",1934,3427.37,3923.19,495.82,"increase",7350.56,2249,958,1291
"55",2990,956.45,180.5,-775.95,"increase",1136.95,394,335,59
"56",4412,3965.97,3387.21,-578.76,"increase",7353.18,2992,1572,1420
"57",1726,4452.03,6240.13,1788.1,"increase",10692.16,4010,1613,2397
"58",2384,6649.43,7179.56,530.13,"increase",13828.99,5213,2442,2771
"59",2918,3947.99,8121.62,4173.63,"increase",12069.61,6987,2716,4271
"60",3502,0,14.55,14.55,"increase",14.55,5,0,5
"61",4682,4274.64,2795.92,-1478.72,"increase",7070.56,1846,1069,777
"62",269,6442.46,7823.74,1381.28,"increase",14266.2,5454,2504,2950
"63",880,4796.1,5385.47,589.37,"increase",10181.57,3265,1549,1716
"64",3395,3192.3,3447.95,255.65,"increase",6640.25,2581,1288,1293
"65",1096,1316.14,1279.1,-37.0400000000002,"increase",2595.24,952,464,488
"66",4811,6306.67,5391.51,-915.16,"increase",11698.18,3390,1820,1570
"67",4357,2512.58,2808.91,296.33,"increase",5321.49,2098,1016,1082
"68",4474,4293.22,4559.78,266.559999999999,"increase",8853,2879,1391,1488
"69",1549,3296.86,4755.89,1459.03,"increase",8052.75,4701,1894,2807
"70",20,193.47,3.34,-190.13,"increase",196.81,48,47,1
"71",25,2413.69,2913.51,499.82,"increase",5327.2,2031,971,1060
"72",50,0,142.47,142.47,"increase",142.47,69,0,69
"73",71,4273.62,4419.62,146,"increase",8693.24,2957,1391,1566
"74",73,37.39,40.24,2.85,"increase",77.63,26,17,9
"75",78,0,161.36,161.36,"increase",161.36,70,0,70
"76",86,1098.19,1284.99,186.8,"increase",2383.18,738,349,389
"77",89,0,27.8,27.8,"increase",27.8,11,0,11
"78",90,5859.73,5400.86,-458.870000000001,"increase",11260.59,4821,2523,2298
"79",91,1516.97,2789.27,1272.3,"increase",4306.24,1756,604,1152
"80",94,3857.9,3282.97,-574.93,"increase",7140.87,2110,1149,961
"81",105,7418.53,7555.35,136.820000000001,"increase",14973.88,5608,2827,2781
"82",113,1308.77,2664.46,1355.69,"increase",3973.23,1631,550,1081
"83",114,7.07,4.27,-2.8,"increase",11.34,9,6,3
"84",120,130.2,18.87,-111.33,"increase",149.07,53,50,3
"85",126,1977.95,1654.92,-323.03,"increase",3632.87,1621,887,734
"86",140,2322.81,3447.98,1125.17,"increase",5770.79,1663,661,1002
"87",148,0,5,5,"increase",5,2,0,2
"88",161,4343.78,6300.67,1956.89,"increase",10644.45,4293,1798,2495
"89",164,2100.16,2565.89,465.73,"increase",4666.05,1610,754,856
"90",176,6414.39,5424.81,-989.58,"increase",11839.2,4134,2256,1878
"91",181,3518.62,3125.72,-392.9,"increase",6644.34,2397,1297,1100
"92",186,3149,2787.31,-361.69,"increase",5936.31,1656,917,739
"93",191,0,65.74,65.74,"increase",65.74,24,0,24
"94",206,8854.4,10272.33,1417.93,"increase",19126.73,5816,2821,2995
"95",227,0,48.54,48.54,"increase",48.54,24,0,24
"96",230,0,24.45,24.45,"increase",24.45,11,0,11
"97",253,0,49.61,49.61,"increase",49.61,8,0,8
"98",259,0,196.32,196.32,"increase",196.32,81,0,81
"99",267,0,47.24,47.24,"increase",47.24,11,0,11
"100",280,184.03,0,-184.03,"increase",184.03,52,52,0
"101",284,0,26.71,26.71,"increase",26.71,8,0,8
"102",312,4356.54,4133,-223.54,"increase",8489.54,2904,1515,1389
"103",318,195.23,201.59,6.36000000000001,"increase",396.82,165,80,85
"104",325,6791.9,5276.06,-1515.84,"increase",12067.96,4213,2181,2032
"105",333,0,12.98,12.98,"increase",12.98,2,0,2
"106",341,38.97,46.53,7.56,"increase",85.5,18,4,14
"107",355,0,81.43,81.43,"increase",81.43,25,0,25
"108",366,149.22,17.03,-132.19,"increase",166.25,60,53,7
"109",370,0,77.05,77.05,"increase",77.05,26,0,26
"110",376,2764.22,5511.74,2747.52,"increase",8275.96,3341,1164,2177
"111",380,0,5.26,5.26,"increase",5.26,4,0,4
"112",398,0,64.93,64.93,"increase",64.93,23,0,23
"113",399,61.8,0,-61.8,"increase",61.8,32,32,0
"114",421,0,101.78,101.78,"increase",101.78,29,0,29
"115",430,0,18.26,18.26,"increase",18.26,4,0,4
"116",434,480.71,776.05,295.34,"increase",1256.76,518,213,305
"117",455,8127.1,8831.07,703.969999999999,"increase",16958.17,5351,2486,2865
"118",457,44.88,31.47,-13.41,"increase",76.35,36,14,22
"119",463,1426.13,1658.93,232.8,"increase",3085.06,605,287,318
"120",473,2,0,-2,"increase",2,2,2,0
"121",476,6843.47,6031.35,-812.12,"increase",12874.82,3354,1678,1676
"122",482,4.99,0,-4.99,"increase",4.99,1,1,0
"123",494,0,545.54,545.54,"increase",545.54,168,0,168
"124",515,11.99,0,-11.99,"increase",11.99,1,1,0
"125",516,2524.44,2208.79,-315.65,"increase",4733.23,2477,1362,1115
"126",520,242.91,243.92,1.01000000000002,"increase",486.83,144,86,58
"127",527,2835.42,2207.02,-628.4,"increase",5042.44,2205,1266,939
"128",540,0,71.19,71.19,"increase",71.19,24,0,24
"129",541,31.21,3.66,-27.55,"increase",34.87,16,12,4
"130",544,5360.09,5276.46,-83.6300000000001,"increase",10636.55,4267,2138,2129
"131",555,7218.66,6888.39,-330.27,"increase",14107.05,4437,2284,2153
"132",562,745.25,1740.04,994.79,"increase",2485.29,881,314,567
"133",574,2409.92,2757.47,347.55,"increase",5167.39,2457,1153,1304
"134",577,4670.78,3442.7,-1228.08,"increase",8113.48,2857,1705,1152
"135",593,1524.28,1144.14,-380.14,"increase",2668.42,985,561,424
"136",604,694.04,1290.31,596.27,"increase",1984.35,410,167,243
"137",611,7171.26,7025.15,-146.11,"increase",14196.41,3949,2087,1862
"138",617,1940.77,1800.06,-140.71,"increase",3740.83,2638,1330,1308
"139",643,4155.69,3949.97,-205.719999999999,"increase",8105.66,3079,1681,1398
"140",646,187.57,177.67,-9.89999999999998,"increase",365.24,92,30,62
"141",650,549.32,410.11,-139.21,"increase",959.43,1407,824,583
"142",661,2211.29,2753.97,542.68,"increase",4965.26,1867,851,1016
"143",687,3842.49,2515.01,-1327.48,"increase",6357.5,1852,1117,735
"144",707,0,11.67,11.67,"increase",11.67,4,0,4
"145",716,4222.24,4055.97,-166.27,"increase",8278.21,3050,1569,1481
"146",752,2817.5,3529.98,712.48,"increase",6347.48,2433,1168,1265
"147",760,4964.46,5308.97,344.51,"increase",10273.43,3774,1986,1788
"148",765,2856.41,3071.17,214.76,"increase",5927.58,1737,872,865
"149",791,3750.08,3604.76,-145.32,"increase",7354.84,2282,1178,1104
"150",799,3067.42,2435.03,-632.39,"increase",5502.45,2333,1274,1059
"151",809,3930.7,2017.04,-1913.66,"increase",5947.74,2257,1414,843
"152",814,1611.94,1755.05,143.11,"increase",3366.99,1503,694,809
"153",841,3679.79,30.99,-3648.8,"increase",3710.78,1186,1185,1
"154",866,2160.03,3148.55,988.52,"increase",5308.58,1387,604,783
"155",870,3264.84,3557.72,292.88,"increase",6822.56,2225,1067,1158
"156",876,4234.46,2825.39,-1409.07,"increase",7059.85,2805,1700,1105
"157",883,0,30.55,30.55,"increase",30.55,10,0,10
"158",901,24.98,186.83,161.85,"increase",211.81,36,6,30
"159",914,7083.87,9050.27,1966.4,"increase",16134.14,4952,2503,2449
"160",930,1769.05,2896.76,1127.71,"increase",4665.81,1405,556,849
"161",945,13983.34,11986.11,-1997.23,"increase",25969.45,8806,4901,3905
"162",947,4480.54,5345.91,865.37,"increase",9826.45,2901,1308,1593
"163",950,1972.19,2447.35,475.16,"increase",4419.54,2139,957,1182
"164",967,4290.15,4523.82,233.67,"increase",8813.97,3452,1721,1731
"165",971,3383.01,2058.33,-1324.68,"increase",5441.34,1753,1040,713
"166",973,3739.16,4014.99,275.83,"increase",7754.15,4440,2163,2277
"167",977,2840.78,2845.8,5.01999999999998,"increase",5686.58,2638,1313,1325
"168",980,16244.96,12175.54,-4069.42,"increase",28420.5,12129,6557,5572
"169",991,2237.49,2268.69,31.1999999999998,"increase",4506.18,2480,1177,1303
"170",1000,2267.45,2522.62,255.17,"increase",4790.07,1915,922,993
"171",1003,6692.23,7069.98,377.75,"increase",13762.21,3189,1531,1658
"172",1006,3093.44,3246.5,153.06,"increase",6339.94,2886,1429,1457
"173",1016,5097.94,5182.91,84.9699999999993,"increase",10280.85,3776,1969,1807
"174",1023,5582.57,4939.29,-643.28,"increase",10521.86,3674,1944,1730
"175",1025,4136.33,2979.57,-1156.76,"increase",7115.9,2386,1440,946
"176",1052,132.29,0,-132.29,"increase",132.29,50,50,0
"177",1061,1145.06,1281.63,136.57,"increase",2426.69,620,303,317
"178",1117,2252.27,2513.86,261.59,"increase",4766.13,2655,1317,1338
"179",1128,0,178.88,178.88,"increase",178.88,23,0,23
"180",1149,5838.97,6003.41,164.44,"increase",11842.38,3029,1535,1494
"181",1151,1730.2,1043.05,-687.15,"increase",2773.25,838,543,295
"182",1159,6720.38,7834.2,1113.82,"increase",14554.58,4971,2411,2560
"183",1173,1595.75,2059.82,464.07,"increase",3655.57,1479,670,809
"184",1182,1643.7,1451.13,-192.57,"increase",3094.83,1310,739,571
"185",1227,3058.12,3498.87,440.75,"increase",6556.99,2314,1081,1233
"186",1238,5842.89,8266.61,2423.72,"increase",14109.5,4408,1854,2554
"187",1240,6340.71,6208.87,-131.84,"increase",12549.58,4422,2257,2165
"188",1255,3881.16,5358.1,1476.94,"increase",9239.26,3776,1665,2111
"189",1258,2165.63,2599.47,433.84,"increase",4765.1,2416,1180,1236
"190",1267,3256.74,3570.14,313.4,"increase",6826.88,2626,1284,1342
"191",1285,3189.16,3368.82,179.66,"increase",6557.98,2646,1273,1373
"192",1287,2353.98,2329.92,-24.0599999999999,"increase",4683.9,1374,726,648
"193",1291,107.23,0,-107.23,"increase",107.23,23,23,0
"194",1298,4658.58,3750.34,-908.24,"increase",8408.92,2943,1698,1245
"195",1299,7550.2,6598.8,-951.4,"increase",14149,4621,2437,2184
"196",1310,3000.15,4028.29,1028.14,"increase",7028.44,2713,1242,1471
"197",1318,9793.21,4586.67,-5206.54,"increase",14379.88,4052,2818,1234
"198",1320,46.1,0,-46.1,"increase",46.1,5,5,0
"199",1335,5439.64,6529.51,1089.87,"increase",11969.15,4818,2336,2482
"200",1344,0,4.97,4.97,"increase",4.97,3,0,3
"201",1352,0,67.31,67.31,"increase",67.31,26,0,26
"202",1360,2465.33,2551.25,85.9200000000001,"increase",5016.58,1334,698,636
"203",1361,5055.23,5496.75,441.52,"increase",10551.98,3277,1540,1737
"204",1365,0,23.15,23.15,"increase",23.15,10,0,10
"205",1396,4966.09,5089.26,123.17,"increase",10055.35,3111,1513,1598
"206",1417,4693.49,5091.24,397.75,"increase",9784.73,4067,1843,2224
"207",1424,4427.83,4610.75,182.92,"increase",9038.58,2885,1430,1455
"208",1435,6067.21,5999.43,-67.7799999999997,"increase",12066.64,4714,2675,2039
"209",1439,5830.87,2696.35,-3134.52,"increase",8527.22,2144,1346,798
"210",1456,3588.74,3991.85,403.11,"increase",7580.59,3396,1605,1791
"211",1458,3696.99,4478.98,781.99,"increase",8175.97,2664,1264,1400
"212",1459,2089.07,1806.66,-282.41,"increase",3895.73,1424,763,661
"213",1462,0,4.29,4.29,"increase",4.29,1,0,1
"214",1477,2529.57,2553.84,24.27,"increase",5083.41,2001,987,1014
"215",1485,16829.32,11610.08,-5219.24,"increase",28439.4,9559,5644,3915
"216",1490,6229.51,6354.7,125.19,"increase",12584.21,4023,1915,2108
"217",1493,5929.83,6927.9,998.070000000001,"increase",12857.73,3511,1716,1795
"218",1494,4629.87,5232.17,602.3,"increase",9862.04,3917,1803,2114
"219",1498,6110.16,7295.4,1185.24,"increase",13405.56,5293,2435,2858
"220",1503,0,120.21,120.21,"increase",120.21,45,0,45
"221",1512,3670.8,3202.03,-468.77,"increase",6872.83,2129,1174,955
"222",1513,224.93,0,-224.93,"increase",224.93,94,94,0
"223",1547,4771.88,7809.09,3037.21,"increase",12580.97,5129,1959,3170
"224",1553,3241.36,3676.18,434.82,"increase",6917.54,2439,1058,1381
"225",1565,2495.4,3056.23,560.83,"increase",5551.63,1892,862,1030
"226",1573,7209.04,6360.66,-848.38,"increase",13569.7,4593,2398,2195
"227",1576,32.18,0,-32.18,"increase",32.18,2,2,0
"228",1578,6760.97,8149.14,1388.17,"increase",14910.11,4885,2129,2756
"229",1589,9582.97,7537.24,-2045.73,"increase",17120.21,4760,2668,2092
"230",1595,6184.59,6293.64,109.05,"increase",12478.23,4693,2403,2290
"231",1601,3419.37,3292.82,-126.55,"increase",6712.19,2384,1251,1133
"232",1605,3031.77,2146.37,-885.4,"increase",5178.14,1632,977,655
"233",1607,4861.97,5001.6,139.63,"increase",9863.57,2272,1060,1212
"234",1612,0,53.63,53.63,"increase",53.63,28,0,28
"235",1624,34.41,0,-34.41,"increase",34.41,15,15,0
"236",1637,5673.61,7085.1,1411.49,"increase",12758.71,6457,2844,3613
"237",1649,2659.99,1927.7,-732.29,"increase",4587.69,782,439,343
"238",1658,0,36.92,36.92,"increase",36.92,15,0,15
"239",1665,10.62,41.03,30.41,"increase",51.65,13,4,9
"240",1666,2783.97,2725.23,-58.7399999999998,"increase",5509.2,2724,1397,1327
"241",1667,1264.21,13.95,-1250.26,"increase",1278.16,608,603,5
"242",1671,4580.23,5228.82,648.589999999999,"increase",9809.05,3479,1578,1901
"243",1674,4465.93,4455.99,-9.94000000000051,"increase",8921.92,3768,1991,1777
"244",1679,3553.82,3344.83,-208.99,"increase",6898.65,2803,1455,1348
"245",1685,5565.5,4446.64,-1118.86,"increase",10012.14,3645,2172,1473
"246",1693,67.52,0,-67.52,"increase",67.52,24,24,0
"247",1697,7674.01,6564.96,-1109.05,"increase",14238.97,4017,2156,1861
"248",1712,7016.64,6588.84,-427.8,"increase",13605.48,3628,1790,1838
"249",1713,3072.07,1878.7,-1193.37,"increase",4950.77,1620,868,752
"250",1714,2240.95,2055.86,-185.09,"increase",4296.81,1746,918,828
"251",1715,3061.09,4472.95,1411.86,"increase",7534.04,2085,838,1247
"252",1716,4122.58,4193.54,70.96,"increase",8316.12,3206,1568,1638
"253",1717,848.78,3627.23,2778.45,"increase",4476.01,1784,311,1473
"254",1720,2712.04,5778.33,3066.29,"increase",8490.37,3064,1144,1920
"255",1724,1305.42,968.58,-336.84,"increase",2274,776,452,324
"256",1734,6444.8,5945.88,-498.92,"increase",12390.68,4127,2143,1984
"257",1736,2927.69,3458.02,530.33,"increase",6385.71,2712,1299,1413
"258",1743,6894.37,7382.92,488.55,"increase",14277.29,4997,2418,2579
"259",1745,5119.16,5210.36,91.1999999999998,"increase",10329.52,3450,1690,1760
"260",1747,0,98.5,98.5,"increase",98.5,41,0,41
"261",1752,614.23,1189.36,575.13,"increase",1803.59,918,293,625
"262",1767,0,18.56,18.56,"increase",18.56,7,0,7
"263",1768,6221.23,6894.73,673.5,"increase",13115.96,4687,2242,2445
"264",1772,2515.88,4846.6,2330.72,"increase",7362.48,2640,802,1838
"265",1775,2529.25,1942.46,-586.79,"increase",4471.71,1491,876,615
"266",1784,3145.46,3044.45,-101.01,"increase",6189.91,1939,1029,910
"267",1785,581,609.05,28.05,"increase",1190.05,361,157,204
"268",1788,3655.31,4733.23,1077.92,"increase",8388.54,3419,1343,2076
"269",1792,2182.84,2099.63,-83.21,"increase",4282.47,1564,767,797
"270",1798,3834.8,6641.28,2806.48,"increase",10476.08,3110,1240,1870
"271",1801,4585.63,5571.72,986.09,"increase",10157.35,3585,1673,1912
"272",1805,2449.61,2441.25,-8.36000000000013,"increase",4890.86,1978,1029,949
"273",1830,1464.13,1335.97,-128.16,"increase",2800.1,1385,742,643
"274",1838,5649.3,4705.26,-944.04,"increase",10354.56,3557,1905,1652
"275",1840,4918.24,4760.97,-157.27,"increase",9679.21,2753,1389,1364
"276",1851,4415.01,3390.22,-1024.79,"increase",7805.23,3510,1762,1748
"277",1852,0,126.54,126.54,"increase",126.54,52,0,52
"278",1860,5467.3,5784.97,317.67,"increase",11252.27,5820,2997,2823
"279",1867,4030.33,5414.58,1384.25,"increase",9444.91,3334,1424,1910
"280",1873,4319.73,4040.66,-279.070000000001,"increase",8360.39,2717,1414,1303
"281",1874,2.69,36.97,34.28,"increase",39.66,5,1,4
"282",1875,3306.16,2736.29,-569.87,"increase",6042.45,2901,1592,1309
"283",1878,45.88,0,-45.88,"increase",45.88,10,10,0
"284",1880,3871.74,4875.43,1003.69,"increase",8747.17,3871,1771,2100
"285",1885,2879.32,3078.74,199.42,"increase",5958.06,2035,899,1136
"286",1888,2168.98,1913.78,-255.2,"increase",4082.76,1825,950,875
"287",1891,4252.81,4570.76,317.95,"increase",8823.57,3468,1660,1808
"288",1897,10.55,3.08,-7.47,"increase",13.63,7,5,2
"289",1900,0,74.63,74.63,"increase",74.63,20,0,20
"290",1903,0,11.83,11.83,"increase",11.83,6,0,6
"291",1917,3776.98,4278.95,501.97,"increase",8055.93,4407,2095,2312
"292",1919,122.4,86.45,-35.95,"increase",208.85,106,61,45
"293",1929,8935.6,7368.03,-1567.57,"increase",16303.63,5210,2884,2326
"294",1930,6397.54,6989.69,592.150000000001,"increase",13387.23,5486,2661,2825
"295",1933,3911.47,6886.71,2975.24,"increase",10798.18,2836,1040,1796
"296",1941,0,13.16,13.16,"increase",13.16,4,0,4
"297",1951,1448.56,523.73,-924.83,"increase",1972.29,535,370,165
"298",1957,14301.56,16777.8,2476.24,"increase",31079.36,8341,3967,4374
"299",1964,225.67,0,-225.67,"increase",225.67,94,94,0
"300",1986,39.46,6.29,-33.17,"increase",45.75,22,17,5
"301",1995,2104.54,2186.49,81.9500000000003,"increase",4291.03,1560,753,807
"302",1998,3674.88,4812.83,1137.95,"increase",8487.71,3977,1711,2266
"303",2000,2579.23,2685.21,105.98,"increase",5264.44,3060,1462,1598
"304",2008,2180.75,2143.32,-37.4299999999998,"increase",4324.07,2468,1285,1183
"305",2009,3649.48,3520.51,-128.97,"increase",7169.99,2914,1593,1321
"306",2021,3317.29,2471.8,-845.49,"increase",5789.09,1969,1231,738
"307",2027,2782.05,4153.03,1370.98,"increase",6935.08,2127,780,1347
"308",2029,3488.45,4998.38,1509.93,"increase",8486.83,4091,1613,2478
"309",2072,2216.57,1559.47,-657.1,"increase",3776.04,1628,913,715
"310",2073,2479.07,2139.85,-339.22,"increase",4618.92,1811,920,891
"311",2077,0,50.73,50.73,"increase",50.73,18,0,18
"312",2079,5.99,0,-5.99,"increase",5.99,1,1,0
"313",2080,4.87,0,-4.87,"increase",4.87,1,1,0
"314",2085,4207,6956.79,2749.79,"increase",11163.79,4916,1987,2929
"315",2090,2733.68,3236.93,503.25,"increase",5970.61,2341,1164,1177
"316",2101,3512.81,2571.48,-941.33,"increase",6084.29,1937,1217,720
"317",2105,6171.1,6292.5,121.4,"increase",12463.6,3156,1442,1714
"318",2108,6385,7600.03,1215.03,"increase",13985.03,5321,2504,2817
"319",2111,3899.34,5420.16,1520.82,"increase",9319.5,3184,1486,1698
"320",2114,3260.6,2027.26,-1233.34,"increase",5287.86,1493,954,539
"321",2115,2473.27,2799.4,326.13,"increase",5272.67,1807,862,945
"322",2119,8431.28,9033.76,602.48,"increase",17465.04,5683,2662,3021
"323",2133,2759.56,2323.16,-436.4,"increase",5082.72,1597,887,710
"324",2146,4489.21,4703.25,214.04,"increase",9192.46,3094,1382,1712
"325",2149,5596.05,5301.91,-294.14,"increase",10897.96,3915,2091,1824
"326",2151,2879.11,2940.8,61.6900000000001,"increase",5819.91,2145,1067,1078
"327",2152,11904.55,11928.25,23.7000000000007,"increase",23832.8,10353,5095,5258
"328",2162,2000.3,2501.96,501.66,"increase",4502.26,1574,669,905
"329",2172,8542.15,7871.2,-670.95,"increase",16413.35,3308,1786,1522
"330",2175,3160.41,4481.5,1321.09,"increase",7641.91,3508,1390,2118
"331",2178,3884.26,4900.72,1016.46,"increase",8784.98,2605,1159,1446
"332",2180,2945.72,1779.7,-1166.02,"increase",4725.42,1615,1046,569
"333",2190,0,333.81,333.81,"increase",333.81,87,0,87
"334",2192,5289.8,4219.89,-1069.91,"increase",9509.69,3177,1916,1261
"335",2198,2919.11,3502.19,583.08,"increase",6421.3,3232,1592,1640
"336",2201,4272.15,4643.04,370.89,"increase",8915.19,3001,1353,1648
"337",2222,1840.58,2038.72,198.14,"increase",3879.3,2441,1109,1332
"338",2231,1808.02,2028.38,220.36,"increase",3836.4,1445,692,753
"339",2241,12826.35,10694.04,-2132.31,"increase",23520.39,12119,6604,5515
"340",2252,3611.13,6400.67,2789.54,"increase",10011.8,2793,988,1805
"341",2254,4390.46,4436.45,45.9899999999998,"increase",8826.91,2374,1229,1145
"342",2260,3974.93,4120.59,145.66,"increase",8095.52,2272,1151,1121
"343",2268,4511.92,3654.81,-857.11,"increase",8166.73,2355,1185,1170
"344",2274,1369.53,2506.97,1137.44,"increase",3876.5,1204,449,755
"345",2280,3060.48,2508.32,-552.16,"increase",5568.8,2188,1102,1086
"346",2284,4420.81,3867.35,-553.46,"increase",8288.16,4109,2242,1867
"347",2286,5666.29,7038.83,1372.54,"increase",12705.12,5234,2481,2753
"348",2288,6151.82,7067.82,916,"increase",13219.64,3003,1405,1598
"349",2291,2386.42,1607.69,-778.73,"increase",3994.11,1632,954,678
"350",2300,6060.33,5425.39,-634.94,"increase",11485.72,3637,1923,1714
"351",2304,3073.41,3175.44,102.03,"increase",6248.85,3075,1559,1516
"352",2314,1989.74,3471.42,1481.68,"increase",5461.16,807,216,591
"353",2315,3133.08,3437.75,304.67,"increase",6570.83,2104,1029,1075
"354",2318,2843.49,2057.6,-785.89,"increase",4901.09,1600,882,718
"355",2321,8747.31,10094.87,1347.56,"increase",18842.18,6505,3199,3306
"356",2322,2366.41,3405.07,1038.66,"increase",5771.48,2152,847,1305
"357",2325,6984.49,7592.51,608.02,"increase",14577,5366,2571,2795
"358",2331,4049.93,1544.29,-2505.64,"increase",5594.22,1828,1337,491
"359",2333,5485.62,6682.7,1197.08,"increase",12168.32,3699,1634,2065
"360",2335,1951.54,1384.83,-566.71,"increase",3336.37,1176,710,466
"361",2344,3158.82,2130.96,-1027.86,"increase",5289.78,2174,1212,962
"362",2345,5407.39,6150.29,742.9,"increase",11557.68,3647,1714,1933
"363",2348,5533.19,8805.06,3271.87,"increase",14338.25,5109,2092,3017
"364",2363,2928.76,1737.51,-1191.25,"increase",4666.27,1557,991,566
"365",2365,2566.75,2738.73,171.98,"increase",5305.48,1841,919,922
"366",2374,567.95,1110.35,542.4,"increase",1678.3,665,234,431
"367",2379,4226.24,4714.43,488.190000000001,"increase",8940.67,3994,1880,2114
"368",2382,3245.47,3239.09,-6.38000000000011,"increase",6484.56,2293,1258,1035
"369",2383,7505.67,5618.79,-1886.88,"increase",13124.46,4646,2590,2056
"370",2390,4783.42,5044.4,260.98,"increase",9827.82,2747,1366,1381
"371",2391,8728.7,10431.75,1703.05,"increase",19160.45,6993,3184,3809
"372",2396,5180.15,4908.63,-271.52,"increase",10088.78,4195,2087,2108
"373",2419,3616.13,1661.74,-1954.39,"increase",5277.87,2436,1675,761
"374",2423,4806.36,5522.35,715.990000000001,"increase",10328.71,3555,1679,1876
"375",2484,2003.86,1995.25,-8.61000000000013,"increase",3999.11,2206,1094,1112
"376",2492,0,3.79,3.79,"increase",3.79,1,0,1
"377",2499,10.99,0,-10.99,"increase",10.99,1,1,0
"378",2502,4846.55,5311.84,465.29,"increase",10158.39,3893,1734,2159
"379",2515,3438.28,3317.15,-121.13,"increase",6755.43,2553,1243,1310
"380",2516,7655.32,7589.67,-65.6499999999996,"increase",15244.99,4036,2009,2027
"381",2522,1539.48,1780.84,241.36,"increase",3320.32,1409,649,760
"382",2537,1967.27,2494.47,527.2,"increase",4461.74,2430,1129,1301
"383",2540,10298.68,10834.06,535.379999999999,"increase",21132.74,9110,4059,5051
"384",2541,0,493.22,493.22,"increase",493.22,244,0,244
"385",2554,5230.98,5167.32,-63.6599999999999,"increase",10398.3,3206,1694,1512
"386",2571,3814.05,3566.68,-247.37,"increase",7380.73,2212,1144,1068
"387",2575,82.99,47.68,-35.31,"increase",130.67,41,27,14
"388",2596,4182.52,3048.78,-1133.74,"increase",7231.3,2246,1312,934
"389",2597,3337.61,3989.9,652.29,"increase",7327.51,2192,1025,1167
"390",2613,5155.75,5031.72,-124.03,"increase",10187.47,2952,1510,1442
"391",2620,3148.71,2954.61,-194.1,"increase",6103.32,2583,1330,1253
"392",2621,5111.92,6498.25,1386.33,"increase",11610.17,5948,2670,3278
"393",2624,2537.51,4490.73,1953.22,"increase",7028.24,2609,987,1622
"394",2628,2733.05,3546.35,813.3,"increase",6279.4,2636,1149,1487
"395",2633,2234.89,1763.55,-471.34,"increase",3998.44,1495,867,628
"396",2636,6361.99,3964.69,-2397.3,"increase",10326.68,3684,2186,1498
"397",2647,5839.47,5497.79,-341.68,"increase",11337.26,4863,2368,2495
"398",2656,5254.65,5072.72,-181.929999999999,"increase",10327.37,3245,1577,1668
"399",2657,11577.56,11307.79,-269.769999999999,"increase",22885.35,8322,4440,3882
"400",2670,13692.07,19204.96,5512.89,"increase",32897.03,12918,5169,7749
"401",2677,12.11,38.19,26.08,"increase",50.3,25,11,14
"402",2701,3187.75,3367.87,180.12,"increase",6555.62,3150,1469,1681
"403",2711,3508.15,4846.13,1337.98,"increase",8354.28,1832,865,967
"404",2730,7863.68,4207.89,-3655.79,"increase",12071.57,3533,2280,1253
"405",2732,6722.48,7397,674.52,"increase",14119.48,6303,2979,3324
"406",2738,2642.97,3217.84,574.87,"increase",5860.81,2023,949,1074
"407",2745,143.46,0,-143.46,"increase",143.46,48,48,0
"408",2747,4613.79,5568.06,954.27,"increase",10181.85,4042,1963,2079
"409",2755,3408.3,3069.67,-338.63,"increase",6477.97,3117,1566,1551
"410",2759,5885.84,4989.57,-896.27,"increase",10875.41,5192,2824,2368
"411",2762,3633.94,2638.98,-994.96,"increase",6272.92,2595,1432,1163
"412",2777,2953.53,4806.38,1852.85,"increase",7759.91,3691,1429,2262
"413",2779,3441.46,5169.49,1728.03,"increase",8610.95,2961,1199,1762
"414",2780,6287.27,6504.74,217.469999999999,"increase",12792.01,4704,2353,2351
"415",2783,7437.08,7569.82,132.74,"increase",15006.9,4243,2132,2111
"416",2793,7298.3,8130.59,832.29,"increase",15428.89,5736,2668,3068
"417",2794,63.38,53.19,-10.19,"increase",116.57,55,28,27
"418",2797,1635.08,1456.7,-178.38,"increase",3091.78,1100,561,539
"419",2799,15864.17,11697.53,-4166.64,"increase",27561.7,9353,5188,4165
"420",2809,3280.87,2197.76,-1083.11,"increase",5478.63,1596,990,606
"421",2815,3376.63,3276.16,-100.47,"increase",6652.79,2137,1083,1054
"422",2816,1433.42,1743.26,309.84,"increase",3176.68,874,400,474
"423",2818,7511.25,9093.73,1582.48,"increase",16604.98,5892,2542,3350
"424",2826,3392.81,3437.62,44.8099999999999,"increase",6830.43,2608,1425,1183
"425",2847,3854.23,4882.16,1027.93,"increase",8736.39,3011,1327,1684
"426",2854,5869.66,6041.18,171.52,"increase",11910.84,4163,2094,2069
"427",2863,3664.88,3888.81,223.93,"increase",7553.69,2667,1295,1372
"428",2869,88.69,117.63,28.94,"increase",206.32,57,35,22
"429",2870,6823.95,5212.76,-1611.19,"increase",12036.71,5298,3027,2271
"430",2875,2054.69,2655.05,600.36,"increase",4709.74,2087,833,1254
"431",2881,4038.81,3927,-111.81,"increase",7965.81,3691,2088,1603
"432",2900,12649.18,12873.69,224.51,"increase",25522.87,7084,3497,3587
"433",2901,11776.19,7893,-3883.19,"increase",19669.19,8286,4937,3349
"434",2909,2425.86,4080.98,1655.12,"increase",6506.84,2712,1189,1523
"435",2916,3887.47,3808.23,-79.2400000000002,"increase",7695.7,2803,1393,1410
"436",2923,5686.75,7436.02,1749.27,"increase",13122.77,3898,1774,2124
"437",2924,3290.49,3585.77,295.28,"increase",6876.26,2623,1311,1312
"438",2927,1875.45,1720.93,-154.52,"increase",3596.38,1280,627,653
"439",2931,4777.43,6056.7,1279.27,"increase",10834.13,4075,1779,2296
"440",2950,1379.42,1173.9,-205.52,"increase",2553.32,1036,518,518
"441",2954,3898.44,4370.67,472.23,"increase",8269.11,2597,1259,1338
"442",2959,10150.55,5284.5,-4866.05,"increase",15435.05,5351,3594,1757
"443",2962,2097.36,1940.3,-157.06,"increase",4037.66,1670,865,805
"444",2963,3651.5,3539.21,-112.29,"increase",7190.71,2942,1440,1502
"445",2965,6258.29,5525.37,-732.92,"increase",11783.66,5313,2541,2772
"446",2970,59.44,0,-59.44,"increase",59.44,20,20,0
"447",2973,2251.34,2201.52,-49.8200000000002,"increase",4452.86,2690,1330,1360
"448",2979,2149.24,2500.51,351.27,"increase",4649.75,2513,1196,1317
"449",2988,2241.37,1872.44,-368.93,"increase",4113.81,1557,782,775
"450",2996,3717.64,3798.45,80.8100000000004,"increase",7516.09,2867,1360,1507
"451",2998,7890.96,6922.53,-968.43,"increase",14813.49,5558,2950,2608
"452",3006,9.58,6.69,-2.89,"increase",16.27,10,4,6
"453",3013,7256.66,6544.46,-712.2,"increase",13801.12,5101,2682,2419
"454",3015,13.16,0,-13.16,"increase",13.16,7,7,0
"455",3023,6.78,0,-6.78,"increase",6.78,2,2,0
"456",3025,124.26,0,-124.26,"increase",124.26,37,37,0
"457",3028,4646,5162.39,516.39,"increase",9808.39,2945,1530,1415
"458",3032,8634.36,6771.05,-1863.31,"increase",15405.41,6710,3721,2989
"459",3034,3469.46,2457.63,-1011.83,"increase",5927.09,2595,1443,1152
"460",3036,31.18,0,-31.18,"increase",31.18,13,13,0
"461",3046,3534.3,2952.44,-581.86,"increase",6486.74,2248,1279,969
"462",3048,2300.46,7461.53,5161.07,"increase",9761.99,3495,886,2609
"463",3055,4284.44,5736.37,1451.93,"increase",10020.81,4495,1947,2548
"464",3056,0,197.96,197.96,"increase",197.96,73,0,73
"465",3062,6658.83,9467.17,2808.34,"increase",16126,4304,1765,2539
"466",3064,3973.07,2359.57,-1613.5,"increase",6332.64,2931,1771,1160
"467",3093,0,68.39,68.39,"increase",68.39,18,0,18
"468",3095,3760.84,3536.68,-224.16,"increase",7297.52,2380,1190,1190
"469",3101,7331.57,6326.01,-1005.56,"increase",13657.58,3830,2097,1733
"470",3120,9901.89,10095.12,193.230000000001,"increase",19997.01,6099,3062,3037
"471",3121,10.48,66.15,55.67,"increase",76.63,25,3,22
"472",3122,5482.16,5868.41,386.25,"increase",11350.57,3314,1611,1703
"473",3130,6580.97,6828.88,247.91,"increase",13409.85,5556,2730,2826
"474",3132,7040.64,6592.71,-447.93,"increase",13633.35,3933,2055,1878
"475",3139,3242.97,2349.66,-893.31,"increase",5592.63,3453,2001,1452
"476",3142,30.95,0,-30.95,"increase",30.95,5,5,0
"477",3144,5752.09,5867.09,115,"increase",11619.18,4697,2484,2213
"478",3145,53.81,198.27,144.46,"increase",252.08,83,16,67
"479",3148,20.48,0,-20.48,"increase",20.48,2,2,0
"480",3172,15.07,0,-15.07,"increase",15.07,5,5,0
"481",3179,9585.28,9043.15,-542.130000000001,"increase",18628.43,6112,3073,3039
"482",3189,0,105.49,105.49,"increase",105.49,37,0,37
"483",3190,2909.72,2778.84,-130.88,"increase",5688.56,3049,1597,1452
"484",3197,2177.32,2165.42,-11.9000000000001,"increase",4342.74,1967,975,992
"485",3221,2302.36,3664.86,1362.5,"increase",5967.22,1895,833,1062
"486",3226,5311.92,1874.37,-3437.55,"increase",7186.29,2754,2068,686
"487",3227,0,18.52,18.52,"increase",18.52,8,0,8
"488",3229,106.25,0,-106.25,"increase",106.25,37,37,0
"489",3230,117.18,0,-117.18,"increase",117.18,34,34,0
"490",3236,0,5.88,5.88,"increase",5.88,3,0,3
"491",3251,90.67,0,-90.67,"increase",90.67,23,23,0
"492",3256,3050.83,2302.25,-748.58,"increase",5353.08,2179,1271,908
"493",3265,0,139.73,139.73,"increase",139.73,42,0,42
"494",3301,5198.29,4105.98,-1092.31,"increase",9304.27,3511,2040,1471
"495",3312,215.8,83.61,-132.19,"increase",299.41,97,78,19
"496",3316,44.33,0,-44.33,"increase",44.33,7,7,0
"497",3317,0,46.99,46.99,"increase",46.99,1,0,1
"498",3322,4468.69,4607.07,138.379999999999,"increase",9075.76,2777,1463,1314
"499",3325,2826.97,3240.01,413.04,"increase",6066.98,2726,1257,1469
"500",3330,37.98,0,-37.98,"increase",37.98,20,20,0
"501",3359,0,152.51,152.51,"increase",152.51,58,0,58
"502",3361,7642.3,6499.27,-1143.03,"increase",14141.57,5010,2850,2160
"503",3369,286.19,132.16,-154.03,"increase",418.35,83,59,24
"504",3381,3944.58,4865.75,921.17,"increase",8810.33,4444,1835,2609
"505",3388,2169,2548.73,379.73,"increase",4717.73,2889,1270,1619
"506",3392,11610.49,9521.82,-2088.67,"increase",21132.31,5486,3030,2456
"507",3401,2323.02,3185.93,862.91,"increase",5508.95,1975,846,1129
"508",3405,6825.71,5623.58,-1202.13,"increase",12449.29,4490,2347,2143
"509",3410,0,17.13,17.13,"increase",17.13,5,0,5
"510",3412,5312.49,3329.43,-1983.06,"increase",8641.92,2970,1794,1176
"511",3416,1675.18,1552.2,-122.98,"increase",3227.38,1143,619,524
"512",3433,8616.35,8237.05,-379.300000000001,"increase",16853.4,6728,3234,3494
"513",3434,7601.13,4781.4,-2819.73,"increase",12382.53,4061,2471,1590
"514",3438,3530.51,1547.9,-1982.61,"increase",5078.41,2068,1408,660
"515",3441,0,27.21,27.21,"increase",27.21,7,0,7
"516",3477,5824.68,7550.27,1725.59,"increase",13374.95,4436,1986,2450
"517",3478,2511.44,1663.16,-848.28,"increase",4174.6,1487,827,660
"518",3509,7488.42,6386.97,-1101.45,"increase",13875.39,4575,2396,2179
"519",3516,2734.03,2367.01,-367.02,"increase",5101.04,1772,966,806
"520",3517,4818.85,2881.07,-1937.78,"increase",7699.92,3422,2080,1342
"521",3523,874.13,1769,894.87,"increase",2643.13,915,293,622
"522",3533,2487.38,2270.18,-217.2,"increase",4757.56,2259,1254,1005
"523",3536,10907.25,9652.89,-1254.36,"increase",20560.14,8399,4753,3646
"524",3544,3733.46,3113.49,-619.97,"increase",6846.95,2346,1311,1035
"525",3551,2679.41,1879.81,-799.6,"increase",4559.22,1453,831,622
"526",3568,4065.36,5252.79,1187.43,"increase",9318.15,2307,1072,1235
"527",3571,1367.98,1451.32,83.3399999999999,"increase",2819.3,1078,523,555
"528",3584,7231.71,7942.68,710.97,"increase",15174.39,4249,2135,2114
"529",3588,2062.51,3011.81,949.3,"increase",5074.32,857,281,576
"530",3591,4199.65,3921.89,-277.76,"increase",8121.54,4181,2099,2082
"531",3595,4243.45,2749.73,-1493.72,"increase",6993.18,2071,1333,738
"532",3596,2079.05,2085.24,6.19000000000005,"increase",4164.29,1837,928,909
"533",3597,2211.62,2154.34,-57.2799999999997,"increase",4365.96,2096,1042,1054
"534",3606,416,0,-416,"increase",416,97,97,0
"535",3607,4632.77,4697.5,64.7299999999996,"increase",9330.27,3413,1625,1788
"536",3608,3358.56,3128.98,-229.58,"increase",6487.54,1369,719,650
"537",3621,232,697.81,465.81,"increase",929.81,255,65,190
"538",3626,1910.54,2569.17,658.63,"increase",4479.71,1384,545,839
"539",3647,6455.19,6157.18,-298.01,"increase",12612.37,4982,2574,2408
"540",3651,0,2.5,2.5,"increase",2.5,2,0,2
"541",3653,5143.46,3731.87,-1411.59,"increase",8875.33,3790,2151,1639
"542",3675,2908.9,4566.87,1657.97,"increase",7475.77,2300,936,1364
"543",3683,246.67,317.71,71.04,"increase",564.38,144,69,75
"544",3687,0,368.44,368.44,"increase",368.44,118,0,118
"545",3697,6877.38,6841.5,-35.8800000000001,"increase",13718.88,4623,2300,2323
"546",3714,142.44,279.81,137.37,"increase",422.25,153,64,89
"547",3718,7956.26,4897.5,-3058.76,"increase",12853.76,3991,2520,1471
"548",3719,3403.47,2381.65,-1021.82,"increase",5785.12,2048,1258,790
"549",3722,2262.78,1387.93,-874.85,"increase",3650.71,1339,875,464
"550",3739,5417.39,6903.22,1485.83,"increase",12320.61,4278,1942,2336
"551",3745,2837.04,4424.81,1587.77,"increase",7261.85,2258,1012,1246
"552",3754,4756.44,4700.07,-56.3700000000008,"increase",9456.51,4065,1953,2112
"553",3766,6200.2,6519.41,319.21,"increase",12719.61,4843,2358,2485
"554",3781,1922.8,1457,-465.8,"increase",3379.8,1304,761,543
"555",3791,6176.17,7546.87,1370.7,"increase",13723.04,3072,1265,1807
"556",3807,4442.06,3584.92,-857.14,"increase",8026.98,2690,1529,1161
"557",3811,2498.16,4539.19,2041.03,"increase",7037.35,2453,896,1557
"558",3815,622.33,788.17,165.84,"increase",1410.5,317,133,184
"559",3837,6759.09,7471.39,712.3,"increase",14230.48,4267,2101,2166
"560",3847,3473.73,4739,1265.27,"increase",8212.73,2611,1147,1464
"561",3855,1414.17,1244.54,-169.63,"increase",2658.71,914,461,453
"562",3860,15.89,66.43,50.54,"increase",82.32,23,2,21
"563",3898,1986.93,1449.21,-537.72,"increase",3436.14,986,556,430
"564",3899,6313.58,9588.68,3275.1,"increase",15902.26,3432,1426,2006
"565",3906,20.58,9.99,-10.59,"increase",30.57,10,9,1
"566",3920,0,79.15,79.15,"increase",79.15,18,0,18
"567",3921,6493.57,5242.17,-1251.4,"increase",11735.74,4768,2618,2150
"568",3926,9289.08,7321.14,-1967.94,"increase",16610.22,4589,2795,1794
"569",3927,6665.81,6315.67,-350.14,"increase",12981.48,3227,1616,1611
"570",3958,2592.07,2199.18,-392.89,"increase",4791.25,2256,1151,1105
"571",3965,10219.89,10734.34,514.450000000001,"increase",20954.23,6807,3305,3502
"572",3969,10251.49,7780.47,-2471.02,"increase",18031.96,6742,4040,2702
"573",3978,9274.88,9323.84,48.9600000000009,"increase",18598.72,8721,4361,4360
"574",3981,5876.84,6082.61,205.77,"increase",11959.45,3597,1801,1796
"575",3995,0,620.58,620.58,"increase",620.58,204,0,204
"576",3998,3571.98,4264.72,692.74,"increase",7836.7,3336,1476,1860
"577",4015,9823.85,7866.3,-1957.55,"increase",17690.15,7114,4202,2912
"578",4023,1771.84,1216.96,-554.88,"increase",2988.8,969,593,376
"579",4031,13.68,144.08,130.4,"increase",157.76,85,2,83
"580",4038,4749.72,5057.52,307.8,"increase",9807.24,3077,1592,1485
"581",4045,1.59,0,-1.59,"increase",1.59,1,1,0
"582",4068,10396.01,6830.68,-3565.33,"increase",17226.69,4862,2877,1985
"583",4077,6457.67,7566.65,1108.98,"increase",14024.32,4035,1978,2057
"584",4089,4368.92,3334.21,-1034.71,"increase",7703.13,2530,1419,1111
"585",4096,0,2.39,2.39,"increase",2.39,4,0,4
"586",4114,2715.91,2729.57,13.6600000000003,"increase",5445.48,2089,1049,1040
"587",4127,2558.7,1455.43,-1103.27,"increase",4014.13,1175,805,370
"588",4148,3398.68,2214.13,-1184.55,"increase",5612.81,1995,979,1016
"589",4149,2775.37,1933.15,-842.22,"increase",4708.52,1622,943,679
"590",4152,1.99,0,-1.99,"increase",1.99,1,1,0
"591",4153,8.97,0,-8.97,"increase",8.97,3,3,0
"592",4155,3050.85,2718.94,-331.91,"increase",5769.79,1755,912,843
"593",4163,2956.68,2469.31,-487.37,"increase",5425.99,1592,940,652
"594",4165,1889.59,1472.22,-417.37,"increase",3361.81,853,504,349
"595",4170,3887.26,3033.66,-853.6,"increase",6920.92,2737,1485,1252
"596",4171,13.72,0,-13.72,"increase",13.72,4,4,0
"597",4173,5954.83,5617.06,-337.77,"increase",11571.89,3918,2000,1918
"598",4177,200.37,290.86,90.49,"increase",491.23,112,47,65
"599",4180,0,33.09,33.09,"increase",33.09,14,0,14
"600",4186,6930.57,7315.05,384.48,"increase",14245.62,4018,1770,2248
"601",4188,2112.76,3603.23,1490.47,"increase",5715.99,2076,796,1280
"602",4192,4974.48,6885.78,1911.3,"increase",11860.26,4581,2007,2574
"603",4198,2531.8,2572.73,40.9299999999998,"increase",5104.53,2384,1267,1117
"604",4200,6033.68,4823.25,-1210.43,"increase",10856.93,3257,1809,1448
"605",4202,4962.84,3810.6,-1152.24,"increase",8773.44,2735,1587,1148
"606",4207,1519.47,1123.58,-395.89,"increase",2643.05,687,388,299
"607",4209,2663.76,2771.49,107.73,"increase",5435.25,2854,1342,1512
"608",4211,1493.17,1073.1,-420.07,"increase",2566.27,1336,779,557
"609",4214,5336.38,6695.77,1359.39,"increase",12032.15,4117,1870,2247
"610",4218,24.36,28.34,3.98,"increase",52.7,20,12,8
"611",4225,7722.53,7904.37,181.84,"increase",15626.9,5799,2915,2884
"612",4233,6272.25,4729.27,-1542.98,"increase",11001.52,3139,1984,1155
"613",4234,2634.07,3822.55,1188.48,"increase",6456.62,2266,995,1271
"614",4235,9303.95,9601.32,297.369999999999,"increase",18905.27,6397,3049,3348
"615",4236,9184.42,9285.83,101.41,"increase",18470.25,4922,2445,2477
"616",4243,3348.06,2129.53,-1218.53,"increase",5477.59,1528,841,687
"617",4246,1573.29,1416.23,-157.06,"increase",2989.52,1365,717,648
"618",4250,5965.42,4946.25,-1019.17,"increase",10911.67,4490,2367,2123
"619",4255,2298.83,2743.96,445.13,"increase",5042.79,2963,1344,1619
"620",4257,0,15.37,15.37,"increase",15.37,4,0,4
"621",4262,6290.52,7483.52,1193,"increase",13774.04,3680,1746,1934
"622",4263,1769.52,2731.08,961.56,"increase",4500.6,1691,730,961
"623",4264,4650.66,4054.72,-595.94,"increase",8705.38,3015,1620,1395
"624",4265,0,113.79,113.79,"increase",113.79,49,0,49
"625",4267,2233.64,3222.25,988.61,"increase",5455.89,1502,648,854
"626",4268,0,1583.37,1583.37,"increase",1583.37,679,0,679
"627",4273,3610.88,3167.42,-443.46,"increase",6778.3,3527,1891,1636
"628",4278,4393.67,5182.27,788.6,"increase",9575.94,3227,1367,1860
"629",4279,315.73,0,-315.73,"increase",315.73,125,125,0
"630",4287,0,40.62,40.62,"increase",40.62,11,0,11
"631",4288,1600.09,1396.83,-203.26,"increase",2996.92,1106,609,497
"632",4289,11285.42,9483.97,-1801.45,"increase",20769.39,6722,3819,2903
"633",4291,5350.15,5510.33,160.18,"increase",10860.48,3742,1845,1897
"634",4294,2.5,0,-2.5,"increase",2.5,2,2,0
"635",4296,3934.55,3040.77,-893.78,"increase",6975.32,2757,1476,1281
"636",4299,64.59,0,-64.59,"increase",64.59,40,40,0
"637",4304,11228.72,11865.12,636.400000000001,"increase",23093.84,4333,2112,2221
"638",4306,4398.16,4287.32,-110.84,"increase",8685.48,3476,1821,1655
"639",4316,4.99,20.12,15.13,"increase",25.11,11,1,10
"640",4323,4205.74,2942.16,-1263.58,"increase",7147.9,2727,1557,1170
"641",4326,6513.49,2582.17,-3931.32,"increase",9095.66,3559,2487,1072
"642",4328,12088.53,11615.53,-473,"increase",23704.06,8889,4623,4266
"643",4332,5633.34,5619.46,-13.8800000000001,"increase",11252.8,4043,2071,1972
"644",4336,2552.9,2183.99,-368.91,"increase",4736.89,2225,1168,1057
"645",4342,5392.81,4982.45,-410.360000000001,"increase",10375.26,3525,1810,1715
"646",4343,6245.71,6486.03,240.32,"increase",12731.74,3926,1879,2047
"647",4344,461.8,838.65,376.85,"increase",1300.45,374,137,237
"648",4345,6698.3,8026.9,1328.6,"increase",14725.2,5128,2334,2794
"649",4351,0,8.92,8.92,"increase",8.92,3,0,3
"650",4352,3998.33,3875.36,-122.97,"increase",7873.69,2131,1128,1003
"651",4353,11787.93,5982.3,-5805.63,"increase",17770.23,6228,3727,2501
"652",4359,0,2500.79,2500.79,"increase",2500.79,595,0,595
"653",4360,21.96,0,-21.96,"increase",21.96,7,7,0
"654",4361,4048.47,4689.55,641.08,"increase",8738.02,3840,1881,1959
"655",4364,4932.28,4641.71,-290.57,"increase",9573.99,3517,1831,1686
"656",4368,18970.44,11881.19,-7089.25,"increase",30851.63,14024,9069,4955
"657",4369,8964.74,8376.95,-587.789999999999,"increase",17341.69,4512,2434,2078
"658",4370,2054.67,2042.27,-12.4000000000001,"increase",4096.94,1927,1016,911
"659",4371,168.26,243.87,75.61,"increase",412.13,170,83,87
"660",4372,9542.06,7568.49,-1973.57,"increase",17110.55,6103,3424,2679
"661",4378,5088.45,7952.84,2864.39,"increase",13041.29,3868,1596,2272
"662",4380,6052.38,7746.07,1693.69,"increase",13798.45,4994,2276,2718
"663",4382,3288.53,3368.32,79.79,"increase",6656.85,1718,883,835
"664",4385,4432.7,4972.05,539.35,"increase",9404.75,3649,1752,1897
"665",4386,4637.04,3773.79,-863.25,"increase",8410.83,2797,1518,1279
"666",4387,2057.36,3826.3,1768.94,"increase",5883.66,2350,870,1480
"667",4388,2694.74,3382.52,687.78,"increase",6077.26,3526,1683,1843
"668",4390,1362.12,1428.87,66.75,"increase",2790.99,1459,685,774
"669",4392,0,594.89,594.89,"increase",594.89,177,0,177
"670",4396,1957.23,1791.05,-166.18,"increase",3748.28,1364,730,634
"671",4398,7703.67,7335.49,-368.18,"increase",15039.16,4271,2200,2071
"672",4400,2250.36,3227.85,977.49,"increase",5478.21,1898,835,1063
"673",4403,3301.53,2107.83,-1193.7,"increase",5409.36,3939,2507,1432
"674",4404,2414.67,2288.21,-126.46,"increase",4702.88,1989,975,1014
"675",4406,32.38,70.61,38.23,"increase",102.99,36,6,30
"676",4413,3368.46,5286.32,1917.86,"increase",8654.78,2783,1062,1721
"677",4414,4219.5,3332.72,-886.78,"increase",7552.22,2952,1626,1326
"678",4416,3232.91,3026.91,-206,"increase",6259.82,3149,1660,1489
"679",4419,8313.19,7519.08,-794.110000000001,"increase",15832.27,4543,2192,2351
"680",4425,9.38,0,-9.38,"increase",9.38,4,4,0
"681",4427,3278.62,3010.01,-268.61,"increase",6288.63,2557,1273,1284
"682",4431,2649.4,4063.33,1413.93,"increase",6712.73,2552,1165,1387
"683",4432,1741.72,1383.45,-358.27,"increase",3125.17,1679,1005,674
"684",4441,2675.67,4271.53,1595.86,"increase",6947.2,1731,596,1135
"685",4443,39.42,0,-39.42,"increase",39.42,10,10,0
"686",4445,8946.93,8529.34,-417.59,"increase",17476.27,7342,3618,3724
"687",4446,11919.5,9771.93,-2147.57,"increase",21691.43,9918,4969,4949
"688",4451,0,64.11,64.11,"increase",64.11,25,0,25
"689",4453,6918.21,6871.05,-47.1599999999999,"increase",13789.26,5700,2746,2954
"690",4456,38.9,0,-38.9,"increase",38.9,16,16,0
"691",4457,2032.57,2901.04,868.47,"increase",4933.61,1566,672,894
"692",4458,3968.22,5692.94,1724.72,"increase",9661.16,4556,2041,2515
"693",4460,5612.15,7277.83,1665.68,"increase",12889.98,5436,2369,3067
"694",4461,5903.56,6741.95,838.39,"increase",12645.51,2453,1081,1372
"695",4463,3366.32,2556.97,-809.35,"increase",5923.29,2763,1588,1175
"696",4464,2288.33,1954.12,-334.21,"increase",4242.45,1961,1067,894
"697",4465,0,84.44,84.44,"increase",84.44,18,0,18
"698",4468,1874.52,1921.47,46.95,"increase",3795.99,1458,658,800
"699",4473,5539.86,5336.81,-203.049999999999,"increase",10876.67,4092,2042,2050
"700",4476,4046.37,3176.75,-869.62,"increase",7223.12,2813,1690,1123
"701",4479,3918.23,4359.57,441.34,"increase",8277.8,2500,1174,1326
"702",4480,2859.58,2402.22,-457.36,"increase",5261.8,2478,1361,1117
"703",4484,4424.03,3713.74,-710.29,"increase",8137.77,2680,1509,1171
"704",4491,131.2,0,-131.2,"increase",131.2,48,48,0
"705",4493,1525.74,1169.91,-355.83,"increase",2695.65,925,506,419
"706",4496,2035.84,1514.58,-521.26,"increase",3550.42,1231,767,464
"707",4497,5047.67,3327.33,-1720.34,"increase",8375,2845,1808,1037
"708",4501,4,22.87,18.87,"increase",26.87,5,2,3
"709",4504,3902.61,3380.13,-522.48,"increase",7282.74,2900,1397,1503
"710",4506,3948.31,4600.59,652.28,"increase",8548.9,3720,1694,2026
"711",4507,3006.01,4266.35,1260.34,"increase",7272.36,2984,1178,1806
"712",4508,2892.71,3698.43,805.72,"increase",6591.14,2054,892,1162
"713",4514,2574.74,2661.77,87.0299999999997,"increase",5236.51,1800,965,835
"714",4515,2691.11,3355.92,664.81,"increase",6047.03,1421,601,820
"715",4516,2836.52,4600.2,1763.68,"increase",7436.72,2745,991,1754
"716",4524,1865.66,1634.45,-231.21,"increase",3500.11,1177,591,586
"717",4525,3276.41,3553.07,276.66,"increase",6829.48,2554,1313,1241
"718",4529,12464.61,10311.75,-2152.86,"increase",22776.36,6532,3596,2936
"719",4531,621.74,808.8,187.06,"increase",1430.54,495,217,278
"720",4533,15.7,0,-15.7,"increase",15.7,8,8,0
"721",4537,2173.55,2506.79,333.24,"increase",4680.34,2413,1116,1297
"722",4543,6003.21,7034.98,1031.77,"increase",13038.19,3958,1853,2105
"723",4545,5045.86,6091.48,1045.62,"increase",11137.34,3744,1713,2031
"724",4550,2674.01,3103.96,429.95,"increase",5777.97,2911,1365,1546
"725",4553,4606.74,4872.81,266.070000000001,"increase",9479.55,3565,1805,1760
"726",4554,4267,3250.86,-1016.14,"increase",7517.86,5486,3102,2384
"727",4557,3023.56,3513.34,489.78,"increase",6536.9,3240,1459,1781
"728",4560,3452,3965.52,513.52,"increase",7417.52,3510,1824,1686
"729",4562,3528.41,3258.31,-270.1,"increase",6786.72,2615,1246,1369
"730",4565,4553.42,4372.84,-180.58,"increase",8926.26,3670,1933,1737
"731",4566,2464.59,2795.81,331.22,"increase",5260.4,2088,919,1169
"732",4567,2392.64,2116.93,-275.71,"increase",4509.57,1899,1048,851
"733",4572,9298.65,8964.65,-334,"increase",18263.3,5139,2541,2598
"734",4573,1493.7,1898.73,405.03,"increase",3392.43,1456,655,801
"735",4574,1495.53,2099.05,603.52,"increase",3594.58,1551,609,942
"736",4577,10837.02,11994.67,1157.65,"increase",22831.69,10934,5073,5861
"737",4582,8497.04,9965.23,1468.19,"increase",18462.27,5036,2502,2534
"738",4583,7295.3,5207.87,-2087.43,"increase",12503.17,4488,2580,1908
"739",4586,3077.25,3176.33,99.0799999999999,"increase",6253.58,1935,1005,930
"740",4590,170.88,22.92,-147.96,"increase",193.8,38,30,8
"741",4595,6506.42,6433.19,-73.2299999999996,"increase",12939.61,6551,3241,3310
"742",4597,719.15,611.19,-107.96,"increase",1330.34,445,232,213
"743",4598,6004.76,7693.56,1688.8,"increase",13698.32,6023,2666,3357
"744",4599,3183.08,3867.72,684.64,"increase",7050.8,2271,1048,1223
"745",4600,2464.75,2894.3,429.55,"increase",5359.05,2438,1040,1398
"746",4601,6527.16,7274.15,746.990000000001,"increase",13801.31,5312,2607,2705
"747",4602,3007.79,2910.4,-97.3899999999999,"increase",5918.19,2201,1184,1017
"748",4604,5095.22,8109.27,3014.05,"increase",13204.49,6117,2399,3718
"749",4605,4528.46,3514.71,-1013.75,"increase",8043.17,3560,1931,1629
"750",4606,4016.81,3578.48,-438.33,"increase",7595.29,2397,1361,1036
"751",4609,4633.9,3464.63,-1169.27,"increase",8098.53,2603,1399,1204
"752",4611,2765.13,4435.12,1669.99,"increase",7200.25,3446,1504,1942
"753",4617,1211.52,2204.31,992.79,"increase",3415.83,1250,432,818
"754",4619,4517.89,4062.47,-455.42,"increase",8580.36,3290,1705,1585
"755",4620,7131.3,7608.56,477.26,"increase",14739.86,5615,2797,2818
"756",4630,0,17.66,17.66,"increase",17.66,4,0,4
"757",4632,5685.48,4602.71,-1082.77,"increase",10288.19,2763,1536,1227
"758",4633,5819.74,4616.22,-1203.52,"increase",10435.96,3208,1851,1357
"759",4636,8577.13,6165.64,-2411.49,"increase",14742.77,4184,2443,1741
"760",4637,2311.27,1722.65,-588.62,"increase",4033.92,1967,1046,921
"761",4643,3089.16,3110.85,21.6900000000001,"increase",6200.01,2209,1122,1087
"762",4644,7124.41,4987.52,-2136.89,"increase",12111.93,4608,2719,1889
"763",4645,3536.55,4140.73,604.18,"increase",7677.28,2302,1065,1237
"764",4652,1907.04,1937.25,30.21,"increase",3844.29,1886,1025,861
"765",4657,0,101.44,101.44,"increase",101.44,28,0,28
"766",4658,6202.16,5290.36,-911.8,"increase",11492.52,4279,2269,2010
"767",4660,3224.67,4354.49,1129.82,"increase",7579.16,4167,1903,2264
"768",4662,1551.08,1622.02,70.9400000000001,"increase",3173.1,2173,1085,1088
"769",4669,5470.4,4327.37,-1143.03,"increase",9797.77,4194,2346,1848
"770",4671,2173.58,1229.4,-944.18,"increase",3402.98,1829,1150,679
"771",4672,3013.01,4989.71,1976.7,"increase",8002.72,3805,1418,2387
"772",4673,3490.01,5278.55,1788.54,"increase",8768.56,2890,1231,1659
"773",4674,6875.2,5045.24,-1829.96,"increase",11920.44,5334,3176,2158
"774",4676,30.73,0,-30.73,"increase",30.73,16,16,0
"775",4680,2260.34,2212.29,-48.0500000000002,"increase",4472.63,1801,879,922
"776",4683,2333.43,4669.75,2336.32,"increase",7003.18,2028,743,1285
"777",4684,3861.87,4365.28,503.41,"increase",8227.15,2017,955,1062
"778",4688,0,227.32,227.32,"increase",227.32,48,0,48
"779",4691,8180.16,5716.92,-2463.24,"increase",13897.08,3365,1891,1474
"780",4693,0,60.96,60.96,"increase",60.96,28,0,28
"781",4694,3244.05,4723.66,1479.61,"increase",7967.71,2478,978,1500
"782",4695,3673.45,4372.07,698.62,"increase",8045.52,3217,1481,1736
"783",4698,2351.19,1311.49,-1039.7,"increase",3662.68,1426,903,523
"784",4699,1895.66,2387.25,491.59,"increase",4282.91,1549,678,871
"785",4701,255.56,221.24,-34.32,"increase",476.8,176,91,85
"786",4704,6.99,0,-6.99,"increase",6.99,1,1,0
"787",4706,5546.49,5456.42,-90.0699999999997,"increase",11002.91,3184,1667,1517
"788",4708,4632.68,4469.45,-163.23,"increase",9102.13,3856,1899,1957
"789",4709,0,185.06,185.06,"increase",185.06,69,0,69
"790",4711,5812.61,4292.47,-1520.14,"increase",10105.08,3589,1914,1675
"791",4716,7022.37,6241.71,-780.66,"increase",13264.08,3450,1712,1738
"792",4717,9632.81,9707.36,74.5500000000011,"increase",19340.17,6237,3021,3216
"793",4721,1217.22,1321.82,104.6,"increase",2539.04,1097,533,564
"794",4722,0,23.72,23.72,"increase",23.72,15,0,15
"795",4725,2125.26,2028.64,-96.6200000000001,"increase",4153.9,1455,720,735
"796",4727,2592.64,1079.38,-1513.26,"increase",3672.02,1175,759,416
"797",4728,7049.58,6471.37,-578.21,"increase",13520.95,4601,2031,2570
"798",4729,7968.29,11251.14,3282.85,"increase",19219.43,6612,2849,3763
"799",4730,5250.77,3748.2,-1502.57,"increase",8998.97,4435,2505,1930
"800",4731,3337.18,3626.8,289.62,"increase",6963.98,3680,1851,1829
"801",4732,3881.13,4392.88,511.75,"increase",8274.01,3277,1574,1703
"802",4734,6719.18,7533.19,814.01,"increase",14252.37,5738,2640,3098
"803",4735,0,3.99,3.99,"increase",3.99,1,0,1
"804",4741,1663,0,-1663,"increase",1663,396,396,0
"805",4743,2574.03,2813.5,239.47,"increase",5387.53,1844,888,956
"806",4744,187.56,68.21,-119.35,"increase",255.77,83,61,22
"807",4746,0,39.55,39.55,"increase",39.55,16,0,16
"808",4749,0,18.05,18.05,"increase",18.05,7,0,7
"809",4750,3586.48,4376.52,790.04,"increase",7963,2112,963,1149
"810",4751,2979.54,2948.03,-31.5099999999998,"increase",5927.57,2563,1216,1347
"811",4754,1124.64,1761.5,636.86,"increase",2886.14,1187,489,698
"812",4755,4518.79,3740.39,-778.4,"increase",8259.18,3067,1708,1359
"813",4756,2887.08,3832.18,945.1,"increase",6719.26,1603,759,844
"814",4759,3995.2,4588.16,592.96,"increase",8583.36,2594,1223,1371
"815",4760,1289.14,1493.57,204.43,"increase",2782.71,1586,537,1049
"816",4767,7048.88,5258.63,-1790.25,"increase",12307.51,4032,2329,1703
"817",4770,5154.46,4045.15,-1109.31,"increase",9199.61,2638,1504,1134
"818",4771,2193.27,738.9,-1454.37,"increase",2932.17,1232,989,243
"819",4772,1718.58,1907.13,188.55,"increase",3625.71,2140,1067,1073
"820",4777,0,20.58,20.58,"increase",20.58,9,0,9
"821",4778,0,20.03,20.03,"increase",20.03,5,0,5
"822",4781,7088.21,7287.18,198.97,"increase",14375.39,4877,2422,2455
"823",4783,374.45,127.86,-246.59,"increase",502.31,200,159,41
"824",4784,1656.61,795.91,-860.7,"increase",2452.52,1195,826,369
"825",4785,4194.13,5469.91,1275.78,"increase",9664.04,4080,1672,2408
"826",4786,5426.88,6450.18,1023.3,"increase",11877.06,5110,2309,2801
"827",4789,9112.14,10381.94,1269.8,"increase",19494.08,5701,2679,3022
"828",4790,11343.8,10884.66,-459.139999999999,"increase",22228.46,9253,4639,4614
"829",4792,20.94,0,-20.94,"increase",20.94,6,6,0
"830",4793,1080.07,967.09,-112.98,"increase",2047.16,731,409,322
"831",4794,3108.26,2892.63,-215.63,"increase",6000.89,1798,933,865
"832",4796,799.62,27.94,-771.68,"increase",827.56,307,296,11
"833",4797,4112.01,3075.99,-1036.02,"increase",7188,2932,1594,1338
"834",4803,9048.27,8076.85,-971.42,"increase",17125.12,5775,3063,2712
"835",4804,7082.03,7469.75,387.72,"increase",14551.78,5465,2723,2742
"836",4805,0,58.83,58.83,"increase",58.83,17,0,17
"837",4808,231.72,185.65,-46.07,"increase",417.37,135,63,72
"838",4817,1373.54,1158.83,-214.71,"increase",2532.37,907,534,373
"839",4818,106.01,0,-106.01,"increase",106.01,56,56,0
"840",4819,2429.94,4677.41,2247.47,"increase",7107.35,2517,916,1601
"841",4822,4471.65,3425.21,-1046.44,"increase",7896.86,3988,2166,1822
"842",4823,6642.37,5554.98,-1087.39,"increase",12197.35,3700,2079,1621
"843",4833,3021.01,3693.47,672.46,"increase",6714.48,2377,1054,1323
"844",4835,3114.11,3926.42,812.31,"increase",7040.53,1804,810,994
"845",4836,2646.44,4944.43,2297.99,"increase",7590.87,2103,769,1334
"846",4837,3633.66,3482.62,-151.04,"increase",7116.28,2752,1390,1362
"847",4838,3806.85,2768.03,-1038.82,"increase",6574.88,3359,1844,1515
"848",4840,3610.71,3838.03,227.32,"increase",7448.74,2395,1100,1295
"849",4844,3156.72,2335.24,-821.48,"increase",5491.96,2324,1376,948
"850",4847,2809.75,3496.26,686.51,"increase",6306.01,1016,451,565
"851",4848,106.42,1545.47,1439.05,"increase",1651.89,443,35,408
"852",4850,8083.65,7293.08,-790.570000000001,"increase",15376.73,5515,2875,2640
"853",4851,3260.24,3755.84,495.6,"increase",7016.08,1876,784,1092
"854",4853,4268.93,2408.17,-1860.76,"increase",6677.1,2049,1337,712
"855",4859,99.66,226.65,126.99,"increase",326.31,72,20,52
"856",4860,55.48,154.38,98.9,"increase",209.86,47,18,29
"857",4861,5445.76,8027.59,2581.83,"increase",13473.35,4134,1765,2369
"858",4862,4826.07,5709.17,883.1,"increase",10535.24,4772,2328,2444
"859",4864,7260.05,6431.67,-828.38,"increase",13691.72,3268,1834,1434
"860",4865,117.98,178.18,60.2,"increase",296.16,107,39,68
"861",4867,3906.86,4998.45,1091.59,"increase",8905.31,3387,1510,1877
"862",4869,4627.33,5049.25,421.92,"increase",9676.58,3216,1647,1569
"863",4871,4196.21,2827.38,-1368.83,"increase",7023.59,2069,1257,812
"864",4875,91.42,52.75,-38.67,"increase",144.17,28,21,7
"865",4877,2705.23,5797.11,3091.88,"increase",8502.34,1956,716,1240
"866",4879,5805.22,4869.59,-935.63,"increase",10674.81,5711,3183,2528
"867",4883,0,2.58,2.58,"increase",2.58,2,0,2
"868",4888,1963.83,1870.95,-92.8799999999999,"increase",3834.78,1043,515,528
"869",4890,4531.15,6180.2,1649.05,"increase",10711.35,5353,2220,3133
"870",4892,8.93,12.27,3.34,"increase",21.2,9,6,3
"871",4893,8165.97,7653.16,-512.81,"increase",15819.13,4479,1961,2518
"872",4896,1609.26,1346.29,-262.97,"increase",2955.55,1274,670,604
"873",4900,3422.35,2869.41,-552.94,"increase",6291.76,1960,1058,902
"874",4904,19.45,0,-19.45,"increase",19.45,10,10,0
"875",4905,4409.26,5437.48,1028.22,"increase",9846.74,3799,1612,2187
"876",4906,8011.16,7394.85,-616.309999999999,"increase",15406.01,8032,4099,3933
"877",4908,5632.39,4082.91,-1549.48,"increase",9715.3,3198,1891,1307
"878",4909,3806.68,4902.22,1095.54,"increase",8708.9,2607,1155,1452
"879",4910,0,9.9,9.9,"increase",9.9,6,0,6
"880",4911,2854.87,1827.22,-1027.65,"increase",4682.09,1794,1160,634
"881",4912,3671.62,4758.01,1086.39,"increase",8429.63,2707,1031,1676
"882",4913,16.35,41.88,25.53,"increase",58.23,21,8,13
"883",4916,3519.78,2825.3,-694.48,"increase",6345.08,1438,825,613
"884",4917,8203.07,7522.94,-680.129999999999,"increase",15726.01,4705,2324,2381
"885",4919,10123.3,10551.23,427.93,"increase",20674.53,10356,5013,5343
"886",4920,7038.55,2601.76,-4436.79,"increase",9640.31,3350,2365,985
"887",4921,4118.65,4709.27,590.620000000001,"increase",8827.92,2880,1395,1485
"888",4924,2004.89,2219.85,214.96,"increase",4224.74,2378,1136,1242
"889",4933,9111.08,6418.72,-2692.36,"increase",15529.8,5620,3403,2217
"890",4934,4830.63,4368.89,-461.74,"increase",9199.52,2756,1555,1201
"891",4935,3830.88,3962.08,131.2,"increase",7792.96,3013,1504,1509
"892",4938,0,29.18,29.18,"increase",29.18,3,0,3
"893",4940,2766.47,1748.48,-1017.99,"increase",4514.95,1349,890,459
"894",4942,11,0,-11,"increase",11,2,2,0
"895",4949,2766.62,4105.04,1338.42,"increase",6871.66,2131,869,1262
"896",4951,11064.96,9638.06,-1426.9,"increase",20703.02,7272,3904,3368
"897",4952,3174.86,3914.29,739.43,"increase",7089.15,3135,1452,1683
"898",4954,11577.18,7557.63,-4019.55,"increase",19134.81,7112,4185,2927
"899",4957,5756.96,4382.23,-1374.73,"increase",10139.19,4286,2482,1804
"900",4958,5430.37,7287.83,1857.46,"increase",12718.2,3958,1754,2204
"901",4959,4291.24,6254.83,1963.59,"increase",10546.07,3200,1311,1889
"902",4961,1651.66,3493.92,1842.26,"increase",5145.58,1655,517,1138
"903",4965,6856.99,7475.9,618.910000000001,"increase",14332.89,4389,2200,2189
"904",4966,4040.55,6407.09,2366.54,"increase",10447.64,3968,1633,2335
"905",4967,0,13.88,13.88,"increase",13.88,6,0,6
"906",4968,14611.28,12422.14,-2189.14,"increase",27033.42,7862,4590,3272
"907",4969,3645.62,4188.32,542.7,"increase",7833.94,2856,1335,1521
"908",4970,3041.05,2861.54,-179.51,"increase",5902.59,1938,1019,919
"909",4971,2117.72,2164.91,47.1900000000001,"increase",4282.63,1681,823,858
"910",4972,3506.13,4124.45,618.32,"increase",7630.58,2935,1333,1602
"911",4974,12004.47,10010.71,-1993.76,"increase",22015.18,6730,3582,3148
"912",4975,5428.45,5574.02,145.570000000001,"increase",11002.47,4855,2359,2496
"913",4976,3509.58,5009.2,1499.62,"increase",8518.78,1756,674,1082
"914",4978,27.45,0,-27.45,"increase",27.45,6,6,0
"915",4980,3088.93,2867.68,-221.25,"increase",5956.61,2096,1070,1026
"916",4981,2.5,0,-2.5,"increase",2.5,2,2,0
"917",4982,5424.95,6270.96,846.01,"increase",11695.91,4353,1914,2439
"918",4983,10912.9,9493.94,-1418.96,"increase",20406.84,5773,3129,2644
"919",4984,8306.94,4783.95,-3522.99,"increase",13090.89,3338,2097,1241
"920",4986,9754.88,7967.71,-1787.17,"increase",17722.59,6141,3471,2670
"921",4987,2909.01,2987.6,78.5899999999997,"increase",5896.61,2323,1232,1091
"922",4988,6125.22,6898.16,772.94,"increase",13023.38,5291,2604,2687
"923",4989,5250.44,6750.45,1500.01,"increase",12000.89,4392,2056,2336
"924",4990,2265.13,1799.37,-465.76,"increase",4064.5,1140,600,540
"925",4991,4541.18,4639.68,98.5,"increase",9180.86,4176,2077,2099
"926",4992,13.23,0,-13.23,"increase",13.23,7,7,0
"927",4993,5092.39,7336.15,2243.76,"increase",12428.54,4278,1783,2495
"928",4994,8829.55,11891.73,3062.18,"increase",20721.28,7288,3122,4166
"929",4995,3322.45,4492.24,1169.79,"increase",7814.69,2928,1293,1635
"930",4996,274.25,11.55,-262.7,"increase",285.8,103,98,5
"931",4997,1144.61,1136.74,-7.86999999999989,"increase",2281.35,984,496,488
"932",4998,0,11.98,11.98,"increase",11.98,6,0,6
"933",4999,4773.85,5098.66,324.809999999999,"increase",9872.51,3990,2078,1912
"934",5000,9.58,61.23,51.65,"increase",70.81,30,4,26
"935",45,0,7.07,7.07,"increase",7.07,3,0,3
"936",2545,1759.15,1640.56,-118.59,"increase",3399.71,1518,820,698
"937",3939,3054.06,2887.16,-166.9,"increase",5941.22,1746,962,784
"938",2581,8850.19,8408.76,-441.43,"increase",17258.95,7733,3993,3740
"939",386,8.35,0,-8.35,"increase",8.35,5,5,0
"940",490,2237.16,2932.59,695.43,"increase",5169.75,1894,853,1041
"941",588,5383.78,2300.7,-3083.08,"increase",7684.48,2341,1541,800
"942",592,6361.75,4396.76,-1964.99,"increase",10758.51,5495,3259,2236
"943",596,4782.6,3846.77,-935.83,"increase",8629.37,3317,1846,1471
"944",715,3854.18,3028.19,-825.99,"increase",6882.37,2770,1519,1251
"945",852,6941.45,3661.03,-3280.42,"increase",10602.48,3993,2377,1616
"946",1416,3738.31,3149.72,-588.59,"increase",6888.03,2361,1290,1071
"947",2062,1738.37,2046.77,308.4,"increase",3785.14,1200,560,640
"948",2559,2974.99,2783.73,-191.26,"increase",5758.72,3070,1627,1443
"949",125,0,425.75,425.75,"increase",425.75,33,0,33
"950",387,4.99,0,-4.99,"increase",4.99,1,1,0
"951",1974,4772.27,3320.33,-1451.94,"increase",8092.6,3976,2365,1611
"952",3393,6628.22,2980.02,-3648.2,"increase",9608.24,3247,2239,1008
"953",3695,2889.13,2619.94,-269.19,"increase",5509.07,2553,1332,1221
"954",2349,14541.27,11604.87,-2936.4,"increase",26146.14,10770,6203,4567
"955",389,10.97,0,-10.97,"increase",10.97,3,3,0
"956",2025,6702.14,11098.87,4396.73,"increase",17801.01,5878,2129,3749
"957",2277,5677.64,5515.28,-162.360000000001,"increase",11192.92,5149,2772,2377
"958",3501,4157.8,5098.87,941.07,"increase",9256.67,4124,1841,2283
"959",4447,3923.14,4373.27,450.130000000001,"increase",8296.41,2813,1344,1469
"960",481,4757.22,3088,-1669.22,"increase",7845.22,2751,1745,1006
"961",1825,0,20,20,"increase",20,1,0,1
"962",1969,6586.88,8439.54,1852.66,"increase",15026.42,4856,2181,2675
"963",2034,5697.56,4870.88,-826.68,"increase",10568.44,4479,2333,2146
"964",2320,2462.13,3844.05,1381.92,"increase",6306.18,2610,1156,1454
"965",357,535.05,624.41,89.36,"increase",1159.46,299,131,168
"966",946,4848.72,6083.28,1234.56,"increase",10932,3987,1671,2316
"967",1130,0,29.79,29.79,"increase",29.79,8,0,8
"968",439,48.5,45.38,-3.12,"increase",93.88,36,13,23
"969",1461,15965.37,18317.91,2352.54,"increase",34283.28,11832,5593,6239
"970",3767,6473.36,6242.99,-230.37,"increase",12716.35,5077,2530,2547
"971",1350,6448.81,3797.65,-2651.16,"increase",10246.46,3587,2167,1420
"972",2369,4314.54,5631.2,1316.66,"increase",9945.74,3205,1486,1719
"973",3710,3742.13,3417.95,-324.18,"increase",7160.08,2779,1462,1317
"974",3780,6687.64,7322.08,634.44,"increase",14009.72,5656,2771,2885
"975",3839,6997.07,9602.25,2605.18,"increase",16599.32,5947,2265,3682
"976",4346,2443.02,3078.37,635.35,"increase",5521.39,1801,702,1099
"977",166,0,71.42,71.42,"increase",71.42,34,0,34
"978",3284,3675.48,4108.03,432.55,"increase",7783.51,2624,1230,1394
"979",3996,6517.17,6645.35,128.18,"increase",13162.52,5711,2787,2924
"980",4519,4056.65,2657.79,-1398.86,"increase",6714.44,2663,1639,1024
"981",4956,3274.06,2953.56,-320.5,"increase",6227.62,3012,1508,1504
"982",1107,54.67,41.26,-13.41,"increase",95.93,72,43,29
"983",1831,3296.94,4201.66,904.72,"increase",7498.6,2201,958,1243
"984",3368,11072.08,5706.1,-5365.98,"increase",16778.18,4395,2941,1454
"985",3513,8428.24,10072.66,1644.42,"increase",18500.9,4742,2219,2523
"986",81,0,31.97,31.97,"increase",31.97,3,0,3
"987",4283,5649.29,8767.36,3118.07,"increase",14416.65,3912,1534,2378
"988",1237,8939.54,9922.67,983.129999999999,"increase",18862.21,7779,3811,3968
"989",1539,11635.34,10463.26,-1172.08,"increase",22098.6,7774,4023,3751
"990",4305,4292.75,3062.24,-1230.51,"increase",7354.99,3958,2501,1457
"991",2652,3269.45,3244.18,-25.2700000000004,"increase",6513.63,2350,1215,1135
"992",3217,276.12,361.62,85.5,"increase",637.74,142,63,79
"993",1296,3396.18,2951.6,-444.58,"increase",6347.78,2000,1057,943
"994",1762,8420.86,6380.59,-2040.27,"increase",14801.45,6440,3463,2977
"995",2227,18618.96,5244.88,-13374.08,"increase",23863.84,10285,8345,1940
"996",2566,2718.16,5197.7,2479.54,"increase",7915.86,3343,1274,2069
"997",2952,3127.8,4155.84,1028.04,"increase",7283.64,2466,1019,1447
"998",3823,0,3.99,3.99,"increase",3.99,1,0,1
"999",4659,3059.9,4396.14,1336.24,"increase",7456.04,4226,1833,2393
"1000",569,25.14,0,-25.14,"increase",25.14,6,6,0
"1001",1009,4884.21,1357.54,-3526.67,"increase",6241.75,2273,1782,491
"1002",1348,4451.27,4307.8,-143.47,"increase",8759.07,2561,1184,1377
"1003",1836,7275.41,6833.82,-441.59,"increase",14109.23,5955,3134,2821
"1004",2031,7843.68,3930.86,-3912.82,"increase",11774.54,4365,3062,1303
"1005",3399,2340.97,2114.63,-226.34,"increase",4455.6,1689,887,802
"1006",3524,4014.37,5147.06,1132.69,"increase",9161.43,3533,1561,1972
"1007",3667,2551.25,3018.59,467.34,"increase",5569.84,1930,928,1002
"1008",3696,3641.46,4830.72,1189.26,"increase",8472.18,3215,1346,1869
"1009",586,4314.15,4922.06,607.910000000001,"increase",9236.21,2544,1182,1362
"1010",3664,320.37,195.09,-125.28,"increase",515.46,149,89,60
"1011",276,30.95,0,-30.95,"increase",30.95,5,5,0
"1012",336,4840.29,4569.82,-270.47,"increase",9410.11,4635,2445,2190
"1013",1300,2564.33,2746.56,182.23,"increase",5310.89,1872,896,976
"1014",1608,3512.57,2752.23,-760.34,"increase",6264.8,2849,1521,1328
"1015",1764,3056.33,3556.99,500.66,"increase",6613.32,1862,837,1025
"1016",2640,6934.65,5006.28,-1928.37,"increase",11940.93,4087,2351,1736
"1017",3262,55.58,0,-55.58,"increase",55.58,18,18,0
"1018",3302,4156.78,3811.36,-345.42,"increase",7968.14,2724,1459,1265
"1019",3957,1854.07,2107.45,253.38,"increase",3961.52,1327,619,708
"1020",3973,5852.95,6274.08,421.13,"increase",12127.03,6021,3011,3010
"1021",4522,6909.48,6944.22,34.7399999999998,"increase",13853.7,3838,1944,1894
"1022",4580,9539.54,11557.77,2018.23,"increase",21097.31,6678,3186,3492
"1023",4714,2735.87,2970.47,234.6,"increase",5706.34,1777,807,970
"1024",2734,6400.98,6387.3,-13.6800000000003,"increase",12788.28,5624,2839,2785
"1025",1133,0,1439.24,1439.24,"increase",1439.24,408,0,408
"1026",3248,2673.49,2313.48,-360.01,"increase",4986.97,2313,1205,1108
"1027",3540,8709.28,9807.92,1098.64,"increase",18517.2,4941,2284,2657
"1028",4174,2650.33,1825.17,-825.16,"increase",4475.5,1866,1116,750
"1029",219,2714.91,4396.26,1681.35,"increase",7111.17,2226,945,1281
"1030",1027,2825.45,3278.36,452.91,"increase",6103.81,2772,1322,1450
"1031",1491,1300.23,1130.19,-170.04,"increase",2430.42,1413,716,697
"1032",1936,233.93,285.43,51.5,"increase",519.36,196,89,107
"1033",2035,3949.51,3520.73,-428.78,"increase",7470.24,2832,1509,1323
"1034",2407,1450.32,1339.66,-110.66,"increase",2789.98,769,408,361
"1035",2976,5257.34,3693.61,-1563.73,"increase",8950.95,2631,1578,1053
"1036",3103,4188.13,4221.74,33.6099999999997,"increase",8409.87,3817,1853,1964
"1037",3698,3302.29,3799.39,497.1,"increase",7101.68,1977,988,989
"1038",3782,7254.6,7543.06,288.46,"increase",14797.66,4441,2252,2189
"1039",127,10.96,0,-10.96,"increase",10.96,4,4,0
"1040",634,4555.43,5823.74,1268.31,"increase",10379.17,3394,1493,1901
"1041",1347,5931.86,6237.87,306.01,"increase",12169.73,4470,2106,2364
"1042",1616,6353.88,5230.19,-1123.69,"increase",11584.07,3583,1993,1590
"1043",2919,62.2,132.19,69.99,"increase",194.39,60,21,39
"1044",3059,7341.35,7107.73,-233.62,"increase",14449.08,3650,1866,1784
"1045",3242,72.61,0,-72.61,"increase",72.61,22,22,0
"1046",3953,0,82.04,82.04,"increase",82.04,17,0,17
"1047",4401,4594.41,4477.37,-117.04,"increase",9071.78,3913,2053,1860
"1048",4776,0,42.88,42.88,"increase",42.88,13,0,13
"1049",396,27.04,0,-27.04,"increase",27.04,10,10,0
"1050",621,1107.38,1159.49,52.1099999999999,"increase",2266.87,928,489,439
"1051",2548,5790.99,5132.98,-658.009999999999,"increase",10923.97,3718,2008,1710
"1052",2720,4628.28,3733.39,-894.89,"increase",8361.67,2862,1623,1239
"1053",2744,1244.18,1381.95,137.77,"increase",2626.13,922,457,465
"1054",2893,2923.05,2470.72,-452.33,"increase",5393.77,2012,1061,951
"1055",3158,1635.11,1639.17,4.05999999999995,"increase",3274.28,1149,527,622
"1056",3613,3482.48,3547.81,65.3299999999999,"increase",7030.29,3085,1533,1552
"1057",671,4836.15,4673.53,-162.62,"increase",9509.68,3373,1872,1501
"1058",1476,4285.16,4852.94,567.78,"increase",9138.1,3170,1591,1579
"1059",2611,3908.79,3514.53,-394.26,"increase",7423.32,2912,1514,1398
"1060",4927,8372.17,5817.75,-2554.42,"increase",14189.92,3965,2452,1513
"1061",825,7313.53,6651.71,-661.82,"increase",13965.24,5254,3122,2132
"1062",3917,4733.02,5012.15,279.129999999999,"increase",9745.17,3897,1865,2032
"1063",226,4930.6,4729.93,-200.67,"increase",9660.53,3787,1728,2059
"1064",893,2609.97,2616.38,6.40999999999985,"increase",5226.35,2119,1100,1019
"1065",994,2481.98,2730.94,248.96,"increase",5212.92,2854,1344,1510
"1066",1406,4075.38,4149.75,74.3699999999999,"increase",8225.13,2618,1264,1354
"1067",2364,2235.51,2237.11,1.59999999999991,"increase",4472.62,2678,1271,1407
"1068",2716,2715.12,2450.64,-264.48,"increase",5165.76,2389,1289,1100
"1069",2888,2671.74,2945.85,274.11,"increase",5617.59,3488,1723,1765
"1070",4640,4545.61,4656.66,111.05,"increase",9202.27,3432,1745,1687
"1071",1063,4376.84,4127.58,-249.26,"increase",8504.42,3624,1883,1741
"1072",1561,84.79,0,-84.79,"increase",84.79,35,35,0
"1073",2441,2888.74,1923.07,-965.67,"increase",4811.81,2354,1361,993
"1074",2684,3702.38,2867.51,-834.87,"increase",6569.89,3484,2027,1457
"1075",560,3734.7,4141.15,406.449999999999,"increase",7875.85,3652,1879,1773
"1076",3042,2990.64,3601.77,611.13,"increase",6592.41,3118,1361,1757
"1077",3168,5.99,0,-5.99,"increase",5.99,1,1,0
"1078",3465,2380.78,2528.63,147.85,"increase",4909.41,1428,671,757
"1079",3789,2447.2,2369.31,-77.8899999999999,"increase",4816.51,1453,623,830
"1080",121,2498.43,3254.25,755.82,"increase",5752.68,1778,742,1036
"1081",354,11,20.44,9.44,"increase",31.44,11,4,7
"1082",400,80.63,0,-80.63,"increase",80.63,30,30,0
"1083",461,1709.98,1062.31,-647.67,"increase",2772.29,1224,747,477
"1084",598,1355.08,1544.45,189.37,"increase",2899.53,1054,535,519
"1085",1070,1713.37,2283.32,569.95,"increase",3996.69,1706,775,931
"1086",1409,999.46,794.13,-205.33,"increase",1793.59,454,284,170
"1087",1556,4026.03,2954.72,-1071.31,"increase",6980.75,3510,1960,1550
"1088",2243,3691,6497.06,2806.06,"increase",10188.06,4392,1665,2727
"1089",2439,3140.28,2829.2,-311.08,"increase",5969.48,2712,1380,1332
"1090",2591,2670.29,2497.82,-172.47,"increase",5168.11,1395,713,682
"1091",2883,8216.24,9110.62,894.380000000001,"increase",17326.86,6004,2798,3206
"1092",3258,4,0,-4,"increase",4,2,2,0
"1093",3507,2182.02,1875,-307.02,"increase",4057.02,1633,854,779
"1094",3788,5233.47,4398.54,-834.93,"increase",9632.01,3950,2128,1822
"1095",3849,2704.34,2956.14,251.8,"increase",5660.48,2232,1158,1074
"1096",3959,4781.58,4518.56,-263.02,"increase",9300.14,3319,1722,1597
"1097",4100,259.77,410.27,150.5,"increase",670.04,257,95,162
"1098",4118,7286.87,4241.06,-3045.81,"increase",11527.93,4047,2713,1334
"1099",4172,5680.18,5400.61,-279.570000000001,"increase",11080.79,5521,2909,2612
"1100",4589,4943.36,5959.07,1015.71,"increase",10902.43,4137,1839,2298
"1101",2864,14.16,43.07,28.91,"increase",57.23,17,4,13
"1102",608,4206.37,3641.56,-564.81,"increase",7847.93,3666,1923,1743
"1103",923,2263.97,2056.27,-207.7,"increase",4320.24,1598,853,745
"1104",1304,3735.4,4087.91,352.51,"increase",7823.31,3807,1733,2074
"1105",1421,811.28,729.08,-82.1999999999999,"increase",1540.36,855,436,419
"1106",1489,7859.38,7521.64,-337.74,"increase",15381.02,4971,2600,2371
"1107",1675,66.55,20.88,-45.67,"increase",87.43,26,12,14
"1108",1687,4370.6,2509.91,-1860.69,"increase",6880.51,2352,1632,720
"1109",1729,1845.1,1741.8,-103.3,"increase",3586.9,1233,639,594
"1110",1822,2291.84,2659.05,367.21,"increase",4950.89,1864,899,965
"1111",1877,3813.97,3604.58,-209.39,"increase",7418.55,2173,1097,1076
"1112",2433,2709.08,3872.98,1163.9,"increase",6582.06,2965,1319,1646
"1113",2485,3715.61,4125.25,409.64,"increase",7840.86,3334,1559,1775
"1114",2510,2183.08,2494.61,311.53,"increase",4677.69,2441,1281,1160
"1115",2605,4965.96,3288.34,-1677.62,"increase",8254.3,3721,2299,1422
"1116",2637,2908.61,2306.66,-601.95,"increase",5215.27,1833,1026,807
"1117",2680,4035.76,3068.12,-967.64,"increase",7103.88,3056,1813,1243
"1118",2812,4313.82,5293.61,979.79,"increase",9607.43,4120,1961,2159
"1119",2874,5357.7,5132.64,-225.059999999999,"increase",10490.34,4721,2345,2376
"1120",3016,0,14.28,14.28,"increase",14.28,12,0,12
"1121",3309,1316.18,2716.11,1399.93,"increase",4032.29,1210,436,774
"1122",3383,3490.4,2348.8,-1141.6,"increase",5839.2,1913,1169,744
"1123",3404,2922.59,3000.5,77.9099999999999,"increase",5923.09,2560,1295,1265
"1124",3407,6766.49,7819.17,1052.68,"increase",14585.66,3755,1814,1941
"1125",3409,3051.08,3379.37,328.29,"increase",6430.45,3022,1447,1575
"1126",3431,9970.73,10347.2,376.470000000001,"increase",20317.93,5586,3017,2569
"1127",3446,1971.42,2038.3,66.8799999999999,"increase",4009.72,874,475,399
"1128",3485,4390.53,5010.69,620.160000000001,"increase",9401.22,3323,1470,1853
"1129",3562,4410.65,3487.72,-922.929999999999,"increase",7898.37,2247,1367,880
"1130",3779,4365.83,2305.45,-2060.38,"increase",6671.28,2532,1643,889
"1131",4527,3861.42,1712.6,-2148.82,"increase",5574.02,2443,1639,804
"1132",4634,4891.68,5773.77,882.09,"increase",10665.45,3402,1588,1814
"1133",4726,4250.05,4257.61,7.55999999999949,"increase",8507.66,2413,1172,1241
"1134",4757,1332.24,1292.57,-39.6700000000001,"increase",2624.81,889,416,473
"1135",8,3958.23,3859.43,-98.7999999999997,"increase",7817.66,2584,1382,1202
"1136",353,7361.22,6852.03,-509.190000000001,"increase",14213.25,3186,1597,1589
"1137",784,5689.53,4392.15,-1297.38,"increase",10081.68,3388,1865,1523
"1138",793,8765.19,7780.54,-984.650000000001,"increase",16545.73,5348,2909,2439
"1139",895,3738.77,3513.31,-225.46,"increase",7252.08,1922,1048,874
"1140",1196,35.52,0,-35.52,"increase",35.52,11,11,0
"1141",1378,9802.55,11466.14,1663.59,"increase",21268.69,7956,3327,4629
"1142",1393,5234.65,5286.7,52.0500000000002,"increase",10521.35,2423,1244,1179
"1143",1430,5717.14,6525.87,808.73,"increase",12243.01,3891,1863,2028
"1144",1445,81.72,1.89,-79.83,"increase",83.61,32,31,1
"1145",1540,3009.26,2443.52,-565.74,"increase",5452.78,1863,1049,814
"1146",1789,4318.4,4772.23,453.830000000001,"increase",9090.63,3745,1955,1790
"1147",2177,4704.54,8299.98,3595.44,"increase",13004.52,4239,1650,2589
"1148",2257,2038.18,2411.14,372.96,"increase",4449.32,1962,905,1057
"1149",2468,3361.1,3082.23,-278.87,"increase",6443.33,2111,1086,1025
"1150",2768,4684.47,4408.82,-275.650000000001,"increase",9093.29,3335,2019,1316
"1151",2795,0,14.98,14.98,"increase",14.98,4,0,4
"1152",2951,3579.99,3429.21,-150.78,"increase",7009.2,2639,1324,1315
"1153",3067,133.47,33.66,-99.81,"increase",167.13,85,62,23
"1154",3143,0,115.63,115.63,"increase",115.63,22,0,22
"1155",3166,39.19,70.01,30.82,"increase",109.2,39,12,27
"1156",3335,3128.79,3157.58,28.79,"increase",6286.37,2695,1363,1332
"1157",3432,3183.06,3299.09,116.03,"increase",6482.15,2712,1374,1338
"1158",3451,7954.96,6782.56,-1172.4,"increase",14737.52,5053,2881,2172
"1159",3497,585.25,712.6,127.35,"increase",1297.85,480,193,287
"1160",3585,3779.69,4205.54,425.85,"increase",7985.23,3116,1591,1525
"1161",3893,1874.71,2134.55,259.84,"increase",4009.26,1132,487,645
"1162",3979,0,5.98,5.98,"increase",5.98,2,0,2
"1163",3180,0,10.48,10.48,"increase",10.48,2,0,2
"1164",3419,3222.16,3677.89,455.73,"increase",6900.05,2111,959,1152
"1165",4415,29.62,0,-29.62,"increase",29.62,7,7,0
"1166",58,13.38,34.6,21.22,"increase",47.98,15,3,12
"1167",77,5643.93,4206.35,-1437.58,"increase",9850.28,3370,1890,1480
"1168",95,1951.52,2139.12,187.6,"increase",4090.64,1586,769,817
"1169",138,4538.22,4816.52,278.3,"increase",9354.74,3047,1555,1492
"1170",165,2597.88,2231.89,-365.99,"increase",4829.77,1872,1027,845
"1171",197,2650.71,2681.66,30.9499999999998,"increase",5332.37,1954,954,1000
"1172",287,3751.25,2416.4,-1334.85,"increase",6167.65,2286,1439,847
"1173",293,0,7.99,7.99,"increase",7.99,3,0,3
"1174",299,6342.33,6899.81,557.48,"increase",13242.14,4291,2004,2287
"1175",306,1796.87,2039.33,242.46,"increase",3836.2,1811,858,953
"1176",310,3118.27,3223.48,105.21,"increase",6341.75,2085,903,1182
"1177",375,3130.62,3593.52,462.9,"increase",6724.14,2235,1078,1157
"1178",422,126.76,0,-126.76,"increase",126.76,63,63,0
"1179",429,1446.94,1212.99,-233.95,"increase",2659.93,1331,721,610
"1180",471,354.82,0,-354.82,"increase",354.82,102,102,0
"1181",528,9756.89,9394,-362.889999999999,"increase",19150.89,8538,4311,4227
"1182",614,2864.78,2964.28,99.5,"increase",5829.06,2392,1090,1302
"1183",635,7133.64,6890.12,-243.52,"increase",14023.76,3437,1611,1826
"1184",664,2503.2,2519.14,15.9400000000001,"increase",5022.34,2587,1301,1286
"1185",679,2034.83,2393.8,358.97,"increase",4428.63,2190,1021,1169
"1186",680,4558.33,5007.81,449.48,"increase",9566.14,4517,2161,2356
"1187",691,1606.91,1860.82,253.91,"increase",3467.73,1323,654,669
"1188",730,2339.99,3564.66,1224.67,"increase",5904.65,1604,633,971
"1189",745,3600.71,5270.9,1670.19,"increase",8871.61,3233,1359,1874
"1190",748,878,998.02,120.02,"increase",1876.02,720,334,386
"1191",762,755.32,870.06,114.74,"increase",1625.38,896,437,459
"1192",780,5369.69,7496.93,2127.24,"increase",12866.62,4599,2095,2504
"1193",808,2081.46,2541.44,459.98,"increase",4622.9,1734,793,941
"1194",844,6006.98,7032.72,1025.74,"increase",13039.7,4846,2436,2410
"1195",859,4628.33,2884.7,-1743.63,"increase",7513.03,2348,1503,845
"1196",900,4378.14,4512.49,134.349999999999,"increase",8890.63,4058,1932,2126
"1197",906,3646.99,5673.94,2026.95,"increase",9320.93,2995,1114,1881
"1198",921,0,56.97,56.97,"increase",56.97,14,0,14
"1199",998,2539,2173.99,-365.01,"increase",4712.99,1527,792,735
"1200",1010,68.37,0,-68.37,"increase",68.37,35,35,0
"1201",1032,4913.51,5677.79,764.28,"increase",10591.3,3727,1719,2008
"1202",1079,2475.04,2360.61,-114.43,"increase",4835.65,1787,899,888
"1203",1136,0,10.66,10.66,"increase",10.66,2,0,2
"1204",1140,3836.09,2735.31,-1100.78,"increase",6571.4,2006,1123,883
"1205",1205,4830.46,8202.25,3371.79,"increase",13032.71,4589,1860,2729
"1206",1327,4283.11,2015.67,-2267.44,"increase",6298.78,1988,1407,581
"1207",1371,0,48.39,48.39,"increase",48.39,12,0,12
"1208",1394,6771.95,8004.57,1232.62,"increase",14776.52,4470,2044,2426
"1209",1412,0.69,0,-0.69,"increase",0.69,1,1,0
"1210",1438,4711.72,4298.71,-413.01,"increase",9010.43,2607,1319,1288
"1211",1472,2699.54,3302.43,602.89,"increase",6001.97,2568,1144,1424
"1212",1487,2193.1,2206.32,13.2200000000003,"increase",4399.42,2032,970,1062
"1213",1520,3824.73,3662.95,-161.78,"increase",7487.68,2947,1571,1376
"1214",1524,3634.33,3384.33,-250,"increase",7018.66,2406,1199,1207
"1215",1545,2797.23,2169.14,-628.09,"increase",4966.37,1723,952,771
"1216",1552,1728.08,1899.27,171.19,"increase",3627.35,1728,842,886
"1217",1682,4100.29,3612.86,-487.43,"increase",7713.15,2228,1149,1079
"1218",1800,6.99,0,-6.99,"increase",6.99,1,1,0
"1219",1803,3419.44,3680.11,260.67,"increase",7099.55,2248,1096,1152
"1220",1882,3086.53,2264.12,-822.41,"increase",5350.65,1954,1161,793
"1221",1894,7640.21,6651.56,-988.65,"increase",14291.77,4088,2141,1947
"1222",1909,4190.39,4090.57,-99.8200000000002,"increase",8280.96,2718,1389,1329
"1223",1962,1639.56,2105.07,465.51,"increase",3744.63,1646,688,958
"1224",1963,6746.37,6342.02,-404.349999999999,"increase",13088.39,6691,3285,3406
"1225",1979,6307.85,7145.37,837.52,"increase",13453.22,5851,2688,3163
"1226",2053,2360.18,2337.3,-22.8799999999997,"increase",4697.48,2066,1045,1021
"1227",2166,3486.82,3475.48,-11.3400000000001,"increase",6962.3,1516,751,765
"1228",2203,2771.35,2399.87,-371.48,"increase",5171.22,2144,1143,1001
"1229",2224,5955.35,4694.42,-1260.93,"increase",10649.77,5776,3191,2585
"1230",2253,5087.98,6912.52,1824.54,"increase",12000.5,3892,1556,2336
"1231",2387,3759.83,3047.82,-712.01,"increase",6807.65,2662,1445,1217
"1232",2481,4937.75,5189.76,252.01,"increase",10127.51,2540,1289,1251
"1233",2498,886.58,914.78,28.1999999999999,"increase",1801.36,694,361,333
"1234",2526,2158.32,2044.24,-114.08,"increase",4202.56,2000,1068,932
"1235",2550,3435.88,3736.39,300.51,"increase",7172.27,2632,1206,1426
"1236",2642,2127.42,2280.31,152.89,"increase",4407.73,2209,1081,1128
"1237",2675,2137.86,1896.74,-241.12,"increase",4034.6,2770,1450,1320
"1238",2676,3752.75,4122.12,369.37,"increase",7874.87,2932,1377,1555
"1239",2743,1999.99,3564.37,1564.38,"increase",5564.36,1888,654,1234
"1240",2842,3468.65,3463.83,-4.82000000000016,"increase",6932.48,2156,1104,1052
"1241",2887,2049.29,1969,-80.29,"increase",4018.29,2135,1094,1041
"1242",2892,4252.85,4717.26,464.41,"increase",8970.11,4329,2040,2289
"1243",2898,4764.91,4730.33,-34.5799999999999,"increase",9495.24,3843,1829,2014
"1244",2910,4019.99,3440.63,-579.36,"increase",7460.62,2695,1432,1263
"1245",2935,5047.57,4989.41,-58.1599999999999,"increase",10036.98,4261,2021,2240
"1246",2982,4120.59,3969.5,-151.09,"increase",8090.09,2656,1373,1283
"1247",2992,5306.08,5686.52,380.440000000001,"increase",10992.6,3384,1527,1857
"1248",3058,3789.18,4615.85,826.670000000001,"increase",8405.03,3473,1581,1892
"1249",3146,2943.33,4058.85,1115.52,"increase",7002.18,2941,1175,1766
"1250",3246,0,1502.11,1502.11,"increase",1502.11,447,0,447
"1251",3300,1957.44,1684.67,-272.77,"increase",3642.11,1573,835,738
"1252",3415,2529.51,3647.32,1117.81,"increase",6176.83,2076,871,1205
"1253",3426,1884.91,2021.37,136.46,"increase",3906.28,1614,822,792
"1254",3428,2225.79,0,-2225.79,"increase",2225.79,991,991,0
"1255",3483,7659.65,6413.75,-1245.9,"increase",14073.4,4977,2877,2100
"1256",3553,1692.95,1924.71,231.76,"increase",3617.66,1539,733,806
"1257",3563,4551.86,4285.18,-266.679999999999,"increase",8837.04,3523,1761,1762
"1258",3631,3551.76,2892.62,-659.14,"increase",6444.38,2016,1065,951
"1259",3663,55.26,0,-55.26,"increase",55.26,14,14,0
"1260",3674,2744.88,2400.61,-344.27,"increase",5145.49,3201,1663,1538
"1261",3731,3385.27,3511.97,126.7,"increase",6897.24,1868,954,914
"1262",3763,4185.64,4035.93,-149.71,"increase",8221.57,2737,1347,1390
"1263",3826,9430.89,9694.97,264.08,"increase",19125.86,7021,3562,3459
"1264",3835,3298.18,3700.4,402.22,"increase",6998.58,2007,940,1067
"1265",3897,2785.81,2954.48,168.67,"increase",5740.29,2248,1125,1123
"1266",3947,15.99,0,-15.99,"increase",15.99,1,1,0
"1267",3994,0,557.67,557.67,"increase",557.67,107,0,107
"1268",4055,7625.68,7380.48,-245.2,"increase",15006.16,4343,2193,2150
"1269",4124,1875.98,1702,-173.98,"increase",3577.98,1364,720,644
"1270",4134,5048.94,4473.32,-575.620000000001,"increase",9522.26,3027,1666,1361
"1271",4347,2282.73,2714.53,431.8,"increase",4997.26,2051,943,1108
"1272",4532,4241.97,4035.43,-206.54,"increase",8277.4,2334,1272,1062
"1273",4568,0,333.68,333.68,"increase",333.68,95,0,95
"1274",4977,2043.41,1417.7,-625.71,"increase",3461.11,1878,1090,788
"1275",4041,8.85,0,-8.85,"increase",8.85,6,6,0
"1276",294,0,170.64,170.64,"increase",170.64,41,0,41
"1277",3862,3148.81,3909.58,760.77,"increase",7058.39,3218,1454,1764
"1278",4318,3.79,52.86,49.07,"increase",56.65,21,1,20
"1279",2168,31.99,19.22,-12.77,"increase",51.21,16,12,4
"1280",2375,8147.55,6490.42,-1657.13,"increase",14637.97,3587,2114,1473
"1281",3761,6534.91,9523.26,2988.35,"increase",16058.17,4034,1737,2297
"1282",739,6071.95,6710.62,638.67,"increase",12782.57,5574,2669,2905
"1283",1534,15021.78,12086.76,-2935.02,"increase",27108.54,9192,5157,4035
"1284",2036,15.26,113.34,98.08,"increase",128.6,21,4,17
"1285",2237,2262.78,1830.98,-431.8,"increase",4093.76,1915,1056,859
"1286",2476,3985.71,2536.91,-1448.8,"increase",6522.62,2892,1713,1179
"1287",2845,2624.02,2506.46,-117.56,"increase",5130.48,1950,937,1013
"1288",4882,2532.08,3655.52,1123.44,"increase",6187.6,2568,989,1579
"1289",202,16.73,0,-16.73,"increase",16.73,6,6,0
"1290",1673,0,60.34,60.34,"increase",60.34,15,0,15
"1291",1750,2501.79,3519.7,1017.91,"increase",6021.49,1686,703,983
"1292",2084,5351.38,5342.76,-8.61999999999989,"increase",10694.14,3690,1885,1805
"1293",3814,2892.24,3035.6,143.36,"increase",5927.84,2402,1174,1228
"1294",4594,7118.93,5808.63,-1310.3,"increase",12927.56,4623,2517,2106
"1295",699,4213.22,4627.68,414.46,"increase",8840.9,2848,1433,1415
"1296",1192,5328.96,6094.27,765.31,"increase",11423.23,3458,1679,1779
"1297",1411,2779.23,2420.56,-358.67,"increase",5199.79,1723,1007,716
"1298",1486,4280.99,5126.22,845.23,"increase",9407.21,3579,1686,1893
"1299",1770,7125.73,7721.94,596.21,"increase",14847.67,5910,2704,3206
"1300",1814,22.47,0,-22.47,"increase",22.47,10,10,0
"1301",2272,6475.74,9133.08,2657.34,"increase",15608.82,7800,3064,4736
"1302",2944,4607.59,2822.22,-1785.37,"increase",7429.81,2592,1576,1016
"1303",3020,9.46,162.06,152.6,"increase",171.52,64,5,59
"1304",4147,3804.38,4112.61,308.23,"increase",7916.99,2988,1292,1696
"1305",4298,26.3,59.14,32.84,"increase",85.44,13,5,8
"1306",4505,3161.57,4221.75,1060.18,"increase",7383.32,4518,2064,2454
"1307",405,10975.42,9923.54,-1051.88,"increase",20898.96,6124,3176,2948
"1308",1441,3524.99,2686.41,-838.58,"increase",6211.4,2251,1299,952
"1309",1833,7.24,0,-7.24,"increase",7.24,3,3,0
"1310",943,6172.26,6462.26,290,"increase",12634.52,4191,2003,2188
"1311",1303,6745.06,6773.19,28.1300000000001,"increase",13518.25,4579,2226,2353
"1312",1336,2208.29,2842.58,634.29,"increase",5050.87,2130,884,1246
"1313",1179,6650.86,5774.32,-876.540000000001,"increase",12425.18,4645,2600,2045
"1314",1832,13.77,0,-13.77,"increase",13.77,4,4,0
"1315",2776,10649.5,11425.24,775.74,"increase",22074.74,6796,3394,3402
"1316",2855,1942.47,2383.61,441.14,"increase",4326.08,1379,676,703
"1317",3326,14447.82,13866.75,-581.07,"increase",28314.57,8757,4447,4310
"1318",3600,2414.24,2083.84,-330.4,"increase",4498.08,1539,847,692
"1319",4689,9003.74,10326.11,1322.37,"increase",19329.85,4782,2032,2750
"1320",104,856.28,11.98,-844.3,"increase",868.26,317,315,2
"1321",591,346.73,13.18,-333.55,"increase",359.91,130,122,8
"1322",696,4344.83,4575.82,230.99,"increase",8920.65,2516,1252,1264
"1323",2026,4657.32,5419.43,762.110000000001,"increase",10076.75,2657,1292,1365
"1324",2169,11733.28,11368.33,-364.950000000001,"increase",23101.61,6114,3201,2913
"1325",2183,3537.92,3330.26,-207.66,"increase",6868.18,2306,1146,1160
"1326",2312,8736.04,8725.74,-10.3000000000011,"increase",17461.78,7992,3945,4047
"1327",2519,5414.44,6021.17,606.73,"increase",11435.61,5523,2660,2863
"1328",2832,4283.02,4723.8,440.78,"increase",9006.82,3315,1557,1758
"1329",2849,2626.02,3519.87,893.85,"increase",6145.89,3134,1261,1873
"1330",3206,39.64,106.19,66.55,"increase",145.83,43,16,27
"1331",3537,6068.09,6781.36,713.27,"increase",12849.45,4735,2380,2355
"1332",3870,4497,3194.38,-1302.62,"increase",7691.38,2884,1683,1201
"1333",3975,4161.54,4008.58,-152.96,"increase",8170.12,3167,1643,1524
"1334",4551,2317.12,4434.17,2117.05,"increase",6751.29,2204,967,1237
"1335",4739,1429.01,671.77,-757.24,"increase",2100.78,612,388,224
"1336",99,0,26.85,26.85,"increase",26.85,13,0,13
"1337",1560,1667.34,2780.58,1113.24,"increase",4447.92,1958,738,1220
"1338",1946,182.12,0,-182.12,"increase",182.12,36,36,0
"1339",2276,4444.61,4244.27,-200.339999999999,"increase",8688.88,3034,1563,1471
"1340",2293,2808.7,2216.92,-591.78,"increase",5025.62,2742,1574,1168
"1341",2305,0,75.17,75.17,"increase",75.17,22,0,22
"1342",2736,3154.49,2372.72,-781.77,"increase",5527.21,2359,1373,986
"1343",2825,3302.55,2643.79,-658.76,"increase",5946.34,2608,1662,946
"1344",2926,8039.93,4565.56,-3474.37,"increase",12605.49,3105,1885,1220
"1345",3525,2886.03,2534.91,-351.12,"increase",5420.94,1904,1120,784
"1346",3734,6134.53,10864.51,4729.98,"increase",16999.04,5656,2435,3221
"1347",3813,5222.82,5678.71,455.89,"increase",10901.53,4248,2125,2123
"1348",4151,3596.61,3662.87,66.2599999999998,"increase",7259.48,2405,1202,1203
"1349",4244,2718.36,2876.34,157.98,"increase",5594.7,2482,1224,1258
"1350",4341,4354.85,3814.46,-540.39,"increase",8169.31,2603,1410,1193
"1351",4579,0,156.58,156.58,"increase",156.58,36,0,36
"1352",238,40.66,0,-40.66,"increase",40.66,14,14,0
"1353",1400,15.86,0,-15.86,"increase",15.86,3,3,0
"1354",1782,586.32,147.7,-438.62,"increase",734.02,174,158,16
"1355",1826,3702.63,4642.24,939.61,"increase",8344.87,2825,1220,1605
"1356",2894,3721.69,4241.83,520.14,"increase",7963.52,3485,1598,1887
"1357",3018,10232.81,8558.3,-1674.51,"increase",18791.11,6548,3257,3291
"1358",3225,5.98,0,-5.98,"increase",5.98,2,2,0
"1359",4541,4428.25,3661.19,-767.06,"increase",8089.44,3938,2072,1866
"1360",4736,20.92,0,-20.92,"increase",20.92,15,15,0
"1361",4830,0,91.05,91.05,"increase",91.05,27,0,27
"1362",1744,2710.96,3016.27,305.31,"increase",5727.23,2279,1082,1197
"1363",1844,7432,5068.02,-2363.98,"increase",12500.02,3924,2249,1675
"1364",2171,3815.44,3275.13,-540.31,"increase",7090.57,2344,1255,1089
"1365",2259,10397.55,10093.73,-303.82,"increase",20491.28,6460,3342,3118
"1366",2741,5587.53,4803.24,-784.29,"increase",10390.77,3032,1653,1379
"1367",2831,5550.98,7109.75,1558.77,"increase",12660.73,4474,1929,2545
"1368",4122,8720.29,9532.96,812.67,"increase",18253.25,5356,2501,2855
"1369",4499,3915.91,2114.26,-1801.65,"increase",6030.17,2490,1551,939
"1370",681,5471.67,7300,1828.33,"increase",12771.67,5131,2251,2880
"1371",931,3639.11,1552.66,-2086.45,"increase",5191.77,1726,1216,510
"1372",1263,5491.04,4615.25,-875.79,"increase",10106.29,5706,3076,2630
"1373",1994,5541.28,4657.84,-883.44,"increase",10199.12,4668,2522,2146
"1374",2155,5517.39,9675.6,4158.21,"increase",15192.99,7047,2973,4074
"1375",3907,16132.29,13806.61,-2325.68,"increase",29938.9,14504,7546,6958
"1376",4184,0,410.34,410.34,"increase",410.34,125,0,125
"1377",4510,5092.46,6301.74,1209.28,"increase",11394.2,3587,1724,1863
"1378",600,1567.35,276.63,-1290.72,"increase",1843.98,556,489,67
"1379",807,10551.23,10648.2,96.9700000000012,"increase",21199.43,6810,3338,3472
"1380",894,5618.78,7685.69,2066.91,"increase",13304.47,3298,1438,1860
"1381",1150,7179.85,9225.38,2045.53,"increase",16405.23,5702,2486,3216
"1382",2191,7190.88,8631.68,1440.8,"increase",15822.56,4856,2225,2631
"1383",2400,0,356.24,356.24,"increase",356.24,105,0,105
"1384",2671,3199.45,2454.27,-745.18,"increase",5653.72,2411,1321,1090
"1385",2787,159.86,24.48,-135.38,"increase",184.34,61,58,3
"1386",3072,1721.26,1732.54,11.28,"increase",3453.8,1016,464,552
"1387",3119,0,10.45,10.45,"increase",10.45,5,0,5
"1388",3245,0,16.67,16.67,"increase",16.67,5,0,5
"1389",3261,0,17.97,17.97,"increase",17.97,3,0,3
"1390",3386,5372.39,5442.87,70.4799999999996,"increase",10815.26,3333,1692,1641
"1391",3437,4104.29,3401.3,-702.99,"increase",7505.59,3207,1861,1346
"1392",3479,14.87,0,-14.87,"increase",14.87,2,2,0
"1393",3701,2656.91,1325.39,-1331.52,"increase",3982.3,1301,930,371
"1394",3746,6471.41,2954.4,-3517.01,"increase",9425.81,3064,1986,1078
"1395",4063,27.56,23.2,-4.36,"increase",50.76,11,5,6
"1396",33,1261.31,768,-493.31,"increase",2029.31,754,495,259
"1397",136,0,81.32,81.32,"increase",81.32,43,0,43
"1398",295,671.8,519.69,-152.11,"increase",1191.49,419,229,190
"1399",359,0,26.15,26.15,"increase",26.15,5,0,5
"1400",545,0,50.88,50.88,"increase",50.88,11,0,11
"1401",654,6005.11,6922.74,917.63,"increase",12927.85,4531,2114,2417
"1402",774,3008.39,3029.55,21.1600000000003,"increase",6037.94,3120,1420,1700
"1403",802,1769.02,1957.14,188.12,"increase",3726.16,1400,687,713
"1404",1110,0,60.97,60.97,"increase",60.97,22,0,22
"1405",1146,4432.88,4398.15,-34.7300000000005,"increase",8831.03,5486,2625,2861
"1406",1301,7607.5,6769.96,-837.54,"increase",14377.46,3972,2106,1866
"1407",1345,3510.83,4711.74,1200.91,"increase",8222.57,2774,1234,1540
"1408",1377,0,285.96,285.96,"increase",285.96,87,0,87
"1409",1892,20.79,0,-20.79,"increase",20.79,6,6,0
"1410",2104,3639.93,4218.23,578.300000000001,"increase",7858.16,3356,1462,1894
"1411",2215,3073.41,5032.26,1958.85,"increase",8105.67,2585,1065,1520
"1412",2240,2030.47,2625.69,595.22,"increase",4656.16,1210,540,670
"1413",2311,0,33.49,33.49,"increase",33.49,7,0,7
"1414",2609,4133.67,4136.33,2.65999999999985,"increase",8270,3131,1556,1575
"1415",2631,3787.1,4644,856.9,"increase",8431.1,2047,981,1066
"1416",2641,8639.63,8033.07,-606.559999999999,"increase",16672.7,5793,2923,2870
"1417",2695,7655.89,7218.8,-437.09,"increase",14874.69,4487,2383,2104
"1418",2790,7872.45,8583.68,711.23,"increase",16456.13,6891,3303,3588
"1419",2834,5276.69,7505.41,2228.72,"increase",12782.1,4282,1768,2514
"1420",2958,5514.6,5566.03,51.4299999999994,"increase",11080.63,5335,2651,2684
"1421",3162,0,173.51,173.51,"increase",173.51,123,0,123
"1422",3250,5440.98,5302.76,-138.22,"increase",10743.74,3249,1566,1683
"1423",3575,3977.61,5188.55,1210.94,"increase",9166.16,3791,1626,2165
"1424",3699,4301.46,3454.47,-846.99,"increase",7755.93,2819,1704,1115
"1425",3725,5662.13,5247.4,-414.73,"increase",10909.53,4214,2248,1966
"1426",3825,8091.21,6211.46,-1879.75,"increase",14302.67,5376,3194,2182
"1427",3896,4587.84,3140.81,-1447.03,"increase",7728.65,3203,1902,1301
"1428",3990,11238.38,12761.81,1523.43,"increase",24000.19,6839,3465,3374
"1429",4036,5947.42,5193.58,-753.84,"increase",11141,4525,2370,2155
"1430",4116,0,39.62,39.62,"increase",39.62,21,0,21
"1431",4120,11569.85,17696.5,6126.65,"increase",29266.35,13606,5418,8188
"1432",4274,5459.92,5559.16,99.2399999999998,"increase",11019.08,4176,2043,2133
"1433",4284,2385.8,2380.44,-5.36000000000013,"increase",4766.24,1303,630,673
"1434",4338,0,37.04,37.04,"increase",37.04,18,0,18
"1435",4355,1594.21,2294.33,700.12,"increase",3888.54,1578,667,911
"1436",4535,0,3.59,3.59,"increase",3.59,3,0,3
"1437",4576,4722.31,5936.56,1214.25,"increase",10658.87,4001,1704,2297
"1438",4826,5169.62,5547.14,377.52,"increase",10716.76,4028,1837,2191
"1439",4985,6973.64,6803.43,-170.21,"increase",13777.07,3857,2040,1817
"1440",385,71.55,0,-71.55,"increase",71.55,14,14,0
"1441",402,5566.26,6517.53,951.27,"increase",12083.79,4279,2009,2270
"1442",475,2.99,409.1,406.11,"increase",412.09,88,1,87
"1443",503,7227.08,5626.91,-1600.17,"increase",12853.99,4711,2627,2084
"1444",533,70.3,0,-70.3,"increase",70.3,17,17,0
"1445",546,5424.1,4122.35,-1301.75,"increase",9546.45,3974,2309,1665
"1446",582,7925.96,8850.06,924.099999999999,"increase",16776.02,4502,2179,2323
"1447",616,3010.46,2747.92,-262.54,"increase",5758.38,1953,1020,933
"1448",637,1318.46,1586.9,268.44,"increase",2905.36,1307,565,742
"1449",660,2338.93,6358.94,4020.01,"increase",8697.87,5037,1354,3683
"1450",662,2165.75,1450.34,-715.41,"increase",3616.09,1333,851,482
"1451",711,3310.12,4073.73,763.61,"increase",7383.85,2148,844,1304
"1452",718,8879.83,10383.53,1503.7,"increase",19263.36,6378,3494,2884
"1453",720,8639.54,7141.81,-1497.73,"increase",15781.35,5210,2704,2506
"1454",770,4035.47,4543.34,507.87,"increase",8578.81,3806,1808,1998
"1455",781,3027.45,3474.13,446.68,"increase",6501.58,2141,1062,1079
"1456",857,2121.94,2478.7,356.76,"increase",4600.64,2114,1022,1092
"1457",953,3408.16,3905.14,496.98,"increase",7313.3,3756,1832,1924
"1458",965,6742.65,3282.12,-3460.53,"increase",10024.77,3347,2088,1259
"1459",1074,0,28.13,28.13,"increase",28.13,8,0,8
"1460",1094,180.13,135.8,-44.33,"increase",315.93,98,50,48
"1461",1106,88.65,0,-88.65,"increase",88.65,33,33,0
"1462",1158,7173.51,4175.18,-2998.33,"increase",11348.69,2931,1754,1177
"1463",1427,180.06,93.71,-86.35,"increase",273.77,88,56,32
"1464",1452,12630.83,11399.41,-1231.42,"increase",24030.24,8832,4645,4187
"1465",1793,6572.61,6393.35,-179.259999999999,"increase",12965.96,4036,2121,1915
"1466",1821,1128.5,898.42,-230.08,"increase",2026.92,680,406,274
"1467",1846,8412.1,9312.17,900.07,"increase",17724.27,4526,2241,2285
"1468",1890,8730.55,7655.91,-1074.64,"increase",16386.46,5005,2686,2319
"1469",1923,3602.31,3495.4,-106.91,"increase",7097.71,2608,1265,1343
"1470",2002,0,11.23,11.23,"increase",11.23,4,0,4
"1471",2020,25.36,0,-25.36,"increase",25.36,11,11,0
"1472",2218,10455.25,10378.43,-76.8199999999997,"increase",20833.68,5654,2961,2693
"1473",2267,5256.79,5208.42,-48.3699999999999,"increase",10465.21,4599,2333,2266
"1474",2327,4418.85,3978.85,-440,"increase",8397.7,4568,2626,1942
"1475",2406,341.16,5604.72,5263.56,"increase",5945.88,2054,165,1889
"1476",2507,3663.2,4642.47,979.27,"increase",8305.67,3492,1600,1892
"1477",2533,9383.67,10509.89,1126.22,"increase",19893.56,6690,3073,3617
"1478",2564,5444.38,7106.73,1662.35,"increase",12551.11,3996,1635,2361
"1479",2565,2649.03,1949.33,-699.7,"increase",4598.36,1321,781,540
"1480",2619,6221.69,6223.42,1.72999999999956,"increase",12445.11,5251,2516,2735
"1481",2622,3671.06,3421.2,-249.86,"increase",7092.26,2689,1376,1313
"1482",2625,4831.7,5897.56,1065.86,"increase",10729.26,4404,2160,2244
"1483",2660,4337.52,4682.36,344.839999999999,"increase",9019.88,2440,1149,1291
"1484",2889,11077.84,9852.47,-1225.37,"increase",20930.31,6790,3541,3249
"1485",3011,6218.26,6376.84,158.58,"increase",12595.1,3222,1636,1586
"1486",3043,226.94,0,-226.94,"increase",226.94,85,85,0
"1487",3079,0,191.06,191.06,"increase",191.06,70,0,70
"1488",3092,2170.28,0,-2170.28,"increase",2170.28,892,892,0
"1489",3178,6609.1,6323.41,-285.690000000001,"increase",12932.51,3516,1800,1716
"1490",3186,3238.91,3010.14,-228.77,"increase",6249.05,1813,926,887
"1491",3214,7405.96,5400.24,-2005.72,"increase",12806.2,4755,2874,1881
"1492",3257,2511.92,4456.61,1944.69,"increase",6968.53,2334,887,1447
"1493",3454,1061.58,1867.26,805.68,"increase",2928.84,979,388,591
"1494",3692,12.96,0,-12.96,"increase",12.96,6,6,0
"1495",3786,48.41,0,-48.41,"increase",48.41,12,12,0
"1496",3845,4006.32,5348.98,1342.66,"increase",9355.3,3064,1327,1737
"1497",3887,2190.91,3220.22,1029.31,"increase",5411.13,1771,709,1062
"1498",3913,298.24,383.05,84.81,"increase",681.29,210,87,123
"1499",3933,6289.43,6417.4,127.969999999999,"increase",12706.83,4543,2300,2243
"1500",3940,101.34,54.11,-47.23,"increase",155.45,65,42,23
"1501",4065,3723.22,2317.1,-1406.12,"increase",6040.32,1758,1002,756
"1502",4072,12594.2,11313.39,-1280.81,"increase",23907.59,6864,3666,3198
"1503",4194,2147.09,2937.74,790.65,"increase",5084.83,1187,535,652
"1504",4240,3951.26,2709.4,-1241.86,"increase",6660.66,3384,2003,1381
"1505",4259,5832.42,6799.36,966.94,"increase",12631.78,5536,2617,2919
"1506",4320,1233.3,1455.72,222.42,"increase",2689.02,1326,616,710
"1507",4339,0,8.99,8.99,"increase",8.99,5,0,5
"1508",4411,2341.45,1946.97,-394.48,"increase",4288.42,1445,784,661
"1509",4442,182.77,26,-156.77,"increase",208.77,85,74,11
"1510",4528,0,10.48,10.48,"increase",10.48,2,0,2
"1511",270,361.58,0,-361.58,"increase",361.58,98,98,0
"1512",309,8710.83,9014.46,303.630000000001,"increase",17725.29,7270,3612,3658
"1513",432,16.15,0,-16.15,"increase",16.15,4,4,0
"1514",469,0,116.24,116.24,"increase",116.24,35,0,35
"1515",525,4760.26,4652.59,-107.67,"increase",9412.85,4402,2244,2158
"1516",573,4193.48,4073.26,-120.22,"increase",8266.74,2620,1381,1239
"1517",631,6708.72,7745.57,1036.85,"increase",14454.29,4738,2253,2485
"1518",647,10741.68,12311.71,1570.03,"increase",23053.39,6443,3153,3290
"1519",736,6406.27,6687.75,281.48,"increase",13094.02,3790,1798,1992
"1520",835,5813.4,5805.52,-7.8799999999992,"increase",11618.92,4065,2018,2047
"1521",995,6991.78,7111.24,119.46,"increase",14103.02,5505,2876,2629
"1522",1058,3448.37,5099.19,1650.82,"increase",8547.56,3668,1276,2392
"1523",1302,7609.01,8376.33,767.32,"increase",15985.34,6045,3019,3026
"1524",1468,5448.56,6882.41,1433.85,"increase",12330.97,2969,1240,1729
"1525",1949,0,25.74,25.74,"increase",25.74,8,0,8
"1526",1981,8318.07,6076.87,-2241.2,"increase",14394.94,4288,2610,1678
"1527",2011,10035.88,8812.24,-1223.64,"increase",18848.12,6761,3461,3300
"1528",2040,0,17.38,17.38,"increase",17.38,4,0,4
"1529",2137,0,265.75,265.75,"increase",265.75,38,0,38
"1530",2163,9704.99,11643.51,1938.52,"increase",21348.5,7955,3826,4129
"1531",2219,3675.31,5130.91,1455.6,"increase",8806.22,3563,1412,2151
"1532",2750,2649.65,3004.61,354.96,"increase",5654.26,2288,995,1293
"1533",2761,6679.08,6719.72,40.6400000000003,"increase",13398.8,5858,3026,2832
"1534",2841,2299.78,2422.76,122.98,"increase",4722.54,2442,1176,1266
"1535",3037,6065.54,7412.4,1346.86,"increase",13477.94,4533,2085,2448
"1536",3173,6575.14,7564.68,989.54,"increase",14139.82,5155,2438,2717
"1537",3259,3698.52,4158.67,460.15,"increase",7857.19,1873,895,978
"1538",3558,1529.84,1205.55,-324.29,"increase",2735.39,796,394,402
"1539",3569,2485.12,2531.77,46.6500000000001,"increase",5016.89,2393,1182,1211
"1540",3985,4262.51,6896.99,2634.48,"increase",11159.5,3849,1542,2307
"1541",4275,0,167.47,167.47,"increase",167.47,59,0,59
"1542",4375,802.1,1130.44,328.34,"increase",1932.54,638,233,405
"1543",4495,5497.18,6840.45,1343.27,"increase",12337.63,5490,2477,3013
"1544",4650,4842.75,2036.02,-2806.73,"increase",6878.77,2641,1783,858
"1545",4825,127.62,160.96,33.34,"increase",288.58,97,44,53
"1546",4866,6559.71,5469.44,-1090.27,"increase",12029.15,3215,1693,1522
"1547",214,439.83,433.43,-6.39999999999998,"increase",873.26,258,109,149
"1548",216,60.3,107.36,47.06,"increase",167.66,87,55,32
"1549",350,0,16.2,16.2,"increase",16.2,5,0,5
"1550",875,4404.24,3548.76,-855.48,"increase",7953,3533,1868,1665
"1551",960,3662.49,3188.66,-473.83,"increase",6851.15,2181,1119,1062
"1552",1198,9993.87,9391.88,-601.99,"increase",19385.75,7948,4107,3841
"1553",1410,3529.78,3335.16,-194.62,"increase",6864.94,1989,1061,928
"1554",1943,3.99,0,-3.99,"increase",3.99,1,1,0
"1555",1956,2342.69,3554.08,1211.39,"increase",5896.77,2093,845,1248
"1556",2135,10317.09,11490.08,1172.99,"increase",21807.17,7863,3641,4222
"1557",2401,0,11.42,11.42,"increase",11.42,6,0,6
"1558",2470,4280.02,4282.35,2.32999999999993,"increase",8562.37,3872,1826,2046
"1559",2514,60.24,0,-60.24,"increase",60.24,13,13,0
"1560",2517,65.45,0,-65.45,"increase",65.45,6,6,0
"1561",2618,7739.68,7141.14,-598.54,"increase",14880.82,5637,2946,2691
"1562",2648,8436.66,9700.12,1263.46,"increase",18136.78,7552,3423,4129
"1563",2702,2033.85,3583.74,1549.89,"increase",5617.59,2264,879,1385
"1564",2819,381.86,6.36,-375.5,"increase",388.22,171,168,3
"1565",3053,2930.91,2564.27,-366.64,"increase",5495.18,2080,1042,1038
"1566",3111,4170.5,4225.71,55.21,"increase",8396.21,3023,1546,1477
"1567",3157,5916.17,6505.21,589.04,"increase",12421.38,4412,2035,2377
"1568",3252,15.99,0,-15.99,"increase",15.99,1,1,0
"1569",3318,43.85,0,-43.85,"increase",43.85,15,15,0
"1570",3366,8337.73,2518.55,-5819.18,"increase",10856.28,4597,3512,1085
"1571",3442,5268.91,6107.95,839.04,"increase",11376.86,4297,1992,2305
"1572",3455,4282.44,3433.63,-848.81,"increase",7716.07,2093,1121,972
"1573",3472,2196.93,2689.84,492.91,"increase",4886.77,1921,893,1028
"1574",3481,2101.63,2493.86,392.23,"increase",4595.49,1406,661,745
"1575",3630,9.18,12.67,3.49,"increase",21.85,5,2,3
"1576",3910,7640.01,7446.54,-193.47,"increase",15086.55,5576,2711,2865
"1577",3948,568.07,0,-568.07,"increase",568.07,251,251,0
"1578",4228,138.71,103.78,-34.93,"increase",242.49,82,47,35
"1579",4232,4886.09,8288.69,3402.6,"increase",13174.78,3747,1340,2407
"1580",4389,1413.79,1399.27,-14.52,"increase",2813.06,934,466,468
"1581",4646,5106.87,5649.42,542.55,"increase",10756.29,2755,1353,1402
"1582",314,4688.86,3629.22,-1059.64,"increase",8318.08,4643,2601,2042
"1583",395,0,20.3,20.3,"increase",20.3,10,0,10
"1584",575,8093.19,8880.85,787.66,"increase",16974.04,5704,2802,2902
"1585",705,2252.44,2484.45,232.01,"increase",4736.89,2113,1041,1072
"1586",822,3561.37,2207.13,-1354.24,"increase",5768.5,2725,1729,996
"1587",1001,1812.47,1977.75,165.28,"increase",3790.22,2446,1108,1338
"1588",1368,390.12,742.74,352.62,"increase",1132.86,359,101,258
"1589",3073,3979.7,4013.06,33.3599999999997,"increase",7992.76,2868,1528,1340
"1590",3109,1503.94,1604.12,100.18,"increase",3108.06,1515,695,820
"1591",3269,3837.66,3357.77,-479.89,"increase",7195.43,3128,1590,1538
"1592",3461,2278.39,2649.6,371.21,"increase",4927.99,1708,846,862
"1593",3819,2339.54,2107.66,-231.88,"increase",4447.2,1016,610,406
"1594",4004,6062.52,5641.08,-421.440000000001,"increase",11703.6,5863,3245,2618
"1595",4019,44.14,0,-44.14,"increase",44.14,7,7,0
"1596",123,4157.84,3250.89,-906.95,"increase",7408.73,2539,1621,918
"1597",1099,0,83.6,83.6,"increase",83.6,20,0,20
"1598",1100,4676.34,4089.72,-586.62,"increase",8766.06,3088,1672,1416
"1599",1118,0,49.11,49.11,"increase",49.11,7,0,7
"1600",1204,4713.72,5649.53,935.809999999999,"increase",10363.25,3154,1510,1644
"1601",1256,5998.81,6107.69,108.88,"increase",12106.5,3543,1750,1793
"1602",1506,7685.5,9568.29,1882.79,"increase",17253.79,5071,2156,2915
"1603",1598,167.26,235.2,67.94,"increase",402.46,54,33,21
"1604",1705,4804.2,3852.56,-951.64,"increase",8656.76,2621,1429,1192
"1605",1932,53.23,0,-53.23,"increase",53.23,22,22,0
"1606",2217,6051.54,5000.44,-1051.1,"increase",11051.98,3186,1687,1499
"1607",2334,345.68,236.52,-109.16,"increase",582.2,174,107,67
"1608",2454,144.45,0,-144.45,"increase",144.45,45,45,0
"1609",2586,1044.84,347.64,-697.2,"increase",1392.48,569,448,121
"1610",2683,3932.82,4114.03,181.21,"increase",8046.85,3331,1594,1737
"1611",2995,37.26,123.89,86.63,"increase",161.15,43,4,39
"1612",3021,9.94,0,-9.94,"increase",9.94,6,6,0
"1613",3027,0,26.02,26.02,"increase",26.02,13,0,13
"1614",3035,0,1805.25,1805.25,"increase",1805.25,533,0,533
"1615",3096,2465.91,1804.96,-660.95,"increase",4270.87,1221,710,511
"1616",3126,4926.75,2367.86,-2558.89,"increase",7294.61,2230,1537,693
"1617",3237,471.57,16.94,-454.63,"increase",488.51,159,146,13
"1618",3273,5953.02,6069.98,116.96,"increase",12023,3500,1748,1752
"1619",3345,4600.31,1573.35,-3026.96,"increase",6173.66,2087,1486,601
"1620",3358,2203.97,2303.45,99.48,"increase",4507.42,2872,1388,1484
"1621",3671,1697.63,1160.55,-537.08,"increase",2858.18,883,478,405
"1622",3691,478.69,3.39,-475.3,"increase",482.08,208,204,4
"1623",3727,7744.95,8006.42,261.47,"increase",15751.37,5634,2832,2802
"1624",3744,3394.53,2516.26,-878.27,"increase",5910.79,2330,1326,1004
"1625",3938,4531.74,5109.3,577.56,"increase",9641.04,3290,1614,1676
"1626",4028,4891.89,6197.06,1305.17,"increase",11088.95,4062,1851,2211
"1627",4105,796.55,0,-796.55,"increase",796.55,187,187,0
"1628",4542,9128.7,11364.76,2236.06,"increase",20493.46,6605,3074,3531
"1629",4742,0,29.85,29.85,"increase",29.85,15,0,15
"1630",4812,49.16,0,-49.16,"increase",49.16,12,12,0
"1631",65,3704.2,4594.71,890.51,"increase",8298.91,3783,1799,1984
"1632",145,177.03,0,-177.03,"increase",177.03,69,69,0
"1633",213,3480.73,3112.52,-368.21,"increase",6593.25,2526,1282,1244
"1634",392,0,37.98,37.98,"increase",37.98,18,0,18
"1635",489,3451.3,2872.86,-578.44,"increase",6324.16,3862,2046,1816
"1636",495,2140.51,4875.57,2735.06,"increase",7016.08,3034,956,2078
"1637",697,2580.51,3029.86,449.35,"increase",5610.37,2079,945,1134
"1638",776,3167.34,3454,286.66,"increase",6621.34,3085,1537,1548
"1639",782,5067.36,4167.66,-899.7,"increase",9235.02,3387,1887,1500
"1640",867,4796.52,3717.58,-1078.94,"increase",8514.1,4259,2300,1959
"1641",983,6278.72,7155.68,876.96,"increase",13434.4,5354,2633,2721
"1642",1029,5882.15,5653.88,-228.27,"increase",11536.03,6249,3154,3095
"1643",1064,2795.33,2323.7,-471.63,"increase",5119.03,2431,1313,1118
"1644",1139,7206.76,5711.39,-1495.37,"increase",12918.15,3666,2070,1596
"1645",1325,5090.98,3748.48,-1342.5,"increase",8839.46,3443,1971,1472
"1646",1386,4938.13,6250.7,1312.57,"increase",11188.83,4546,1962,2584
"1647",1464,6116.87,6731.21,614.34,"increase",12848.08,3644,1765,1879
"1648",1507,12355.42,12002.62,-352.799999999999,"increase",24358.04,8569,4016,4553
"1649",1609,2093.29,2857.73,764.44,"increase",4951.02,1520,631,889
"1650",1614,2635.25,2736.79,101.54,"increase",5372.04,2576,1275,1301
"1651",1718,3011.66,2378.05,-633.61,"increase",5389.71,2698,1389,1309
"1652",1871,11841.71,11261.44,-580.27,"increase",23103.15,10410,5151,5259
"1653",1884,16.24,0,-16.24,"increase",16.24,4,4,0
"1654",1907,2464.52,4544.26,2079.74,"increase",7008.78,3022,821,2201
"1655",1935,4084.52,4521.6,437.08,"increase",8606.12,3813,1852,1961
"1656",1955,0,30.64,30.64,"increase",30.64,7,0,7
"1657",1983,8.88,0,-8.88,"increase",8.88,2,2,0
"1658",2200,8285.11,8732.15,447.039999999999,"increase",17017.26,5742,2860,2882
"1659",2330,3757.27,4789.37,1032.1,"increase",8546.64,3809,1661,2148
"1660",2347,0,6.46,6.46,"increase",6.46,3,0,3
"1661",2378,22.21,0,-22.21,"increase",22.21,10,10,0
"1662",2408,5013.36,5212.62,199.26,"increase",10225.98,4200,2116,2084
"1663",2612,2007.36,2068.57,61.21,"increase",4075.93,1958,1018,940
"1664",2630,7615.25,6406.3,-1208.95,"increase",14021.55,3278,1676,1602
"1665",2672,4162.66,7931.47,3768.81,"increase",12094.13,5319,1837,3482
"1666",2709,3303.59,3297.29,-6.30000000000018,"increase",6600.88,3312,1614,1698
"1667",2839,7523.47,6915.46,-608.01,"increase",14438.93,5070,2601,2469
"1668",2947,10163.13,11105.14,942.01,"increase",21268.27,8778,4292,4486
"1669",3010,1770.2,1638.47,-131.73,"increase",3408.67,2053,1114,939
"1670",3084,5549.55,5200.7,-348.85,"increase",10750.25,3333,1725,1608
"1671",3091,3.59,0,-3.59,"increase",3.59,4,4,0
"1672",3268,3218.24,2721.32,-496.92,"increase",5939.56,3092,1685,1407
"1673",3357,2786.73,3225.66,438.93,"increase",6012.39,2029,1002,1027
"1674",3534,4120.37,4502.72,382.35,"increase",8623.09,2548,1362,1186
"1675",3573,4010.9,3880.01,-130.89,"increase",7890.91,3509,1785,1724
"1676",3586,7068.3,4867.8,-2200.5,"increase",11936.1,4564,2659,1905
"1677",3689,0,103.28,103.28,"increase",103.28,30,0,30
"1678",3818,2711.88,2842.12,130.24,"increase",5554,1655,783,872
"1679",3831,89.37,0,-89.37,"increase",89.37,32,32,0
"1680",3858,0,5.76,5.76,"increase",5.76,3,0,3
"1681",3865,8738.31,9170.07,431.76,"increase",17908.38,4606,2280,2326
"1682",3882,30.93,0,-30.93,"increase",30.93,8,8,0
"1683",3942,35.12,0,-35.12,"increase",35.12,8,8,0
"1684",3963,0,122.78,122.78,"increase",122.78,54,0,54
"1685",4032,4040.14,4113.11,72.9699999999998,"increase",8153.25,3158,1579,1579
"1686",4075,6385.93,6274.5,-111.43,"increase",12660.43,5500,2773,2727
"1687",4078,7030.68,7849.43,818.75,"increase",14880.11,4830,2049,2781
"1688",4097,0,52.47,52.47,"increase",52.47,19,0,19
"1689",4719,8357.67,9000.45,642.780000000001,"increase",17358.12,7839,3692,4147
"1690",4946,1330.66,343.04,-987.62,"increase",1673.7,685,541,144
"1691",4963,4491.44,3981.9,-509.54,"increase",8473.34,3605,1750,1855
"1692",3,5266.15,4792.31,-473.839999999999,"increase",10058.46,3826,2047,1779
"1693",59,5990.67,6077.61,86.9399999999996,"increase",12068.28,4572,2240,2332
"1694",119,34.87,90.27,55.4,"increase",125.14,52,15,37
"1695",168,0,107.99,107.99,"increase",107.99,35,0,35
"1696",235,0,62.48,62.48,"increase",62.48,20,0,20
"1697",281,136.36,345.43,209.07,"increase",481.79,71,16,55
"1698",382,3743.85,4148.43,404.58,"increase",7892.28,2580,1278,1302
"1699",409,1973.98,1906.18,-67.8,"increase",3880.16,2312,1183,1129
"1700",472,0,40.13,40.13,"increase",40.13,7,0,7
"1701",603,2819,2631.91,-187.09,"increase",5450.91,2690,1307,1383
"1702",628,5408.81,5049.01,-359.8,"increase",10457.82,3545,1756,1789
"1703",658,9080.42,10943.7,1863.28,"increase",20024.12,6341,2984,3357
"1704",669,2425.25,1265.36,-1159.89,"increase",3690.61,1579,983,596
"1705",810,3775.35,4755.31,979.96,"increase",8530.66,2753,1146,1607
"1706",848,3916.87,4230.74,313.87,"increase",8147.61,3512,1709,1803
"1707",854,10233.54,8777.97,-1455.57,"increase",19011.51,9264,4743,4521
"1708",918,7397.54,7002.59,-394.95,"increase",14400.13,5531,2781,2750
"1709",925,3606.04,6178.18,2572.14,"increase",9784.22,2576,922,1654
"1710",938,5450.39,4856.87,-593.52,"increase",10307.26,4014,2131,1883
"1711",1026,2235.66,4019.96,1784.3,"increase",6255.62,2410,816,1594
"1712",1031,5576.67,4918.16,-658.51,"increase",10494.83,4235,2203,2032
"1713",1092,0,130.97,130.97,"increase",130.97,26,0,26
"1714",1116,0,7.99,7.99,"increase",7.99,1,0,1
"1715",1175,6815.73,7480.03,664.299999999999,"increase",14295.76,6150,2924,3226
"1716",1193,7262.53,5203.04,-2059.49,"increase",12465.57,3539,2128,1411
"1717",1269,16630.89,11900.33,-4730.56,"increase",28531.22,7365,4307,3058
"1718",1332,4412.25,4967.54,555.29,"increase",9379.79,2870,1362,1508
"1719",1333,7111.31,7064.6,-46.71,"increase",14175.91,5635,2907,2728
"1720",1367,6044.59,6245.73,201.14,"increase",12290.32,4282,2143,2139
"1721",1509,3311.49,3982.97,671.48,"increase",7294.46,2303,1036,1267
"1722",1606,5050,4797.51,-252.49,"increase",9847.51,4583,2341,2242
"1723",1615,8708.88,4990.42,-3718.46,"increase",13699.3,5514,3637,1877
"1724",1681,4220.72,4262.28,41.5599999999995,"increase",8483,2365,1212,1153
"1725",1849,20746.25,20264.31,-481.939999999999,"increase",41010.56,20377,10543,9834
"1726",1855,4045.49,4037.81,-7.68000000000029,"increase",8083.3,3026,1609,1417
"1727",1960,4812.91,4367.6,-445.309999999999,"increase",9180.51,3478,1749,1729
"1728",2039,0,93.84,93.84,"increase",93.84,19,0,19
"1729",2065,7544.19,6808.44,-735.75,"increase",14352.63,4182,2167,2015
"1730",2185,951.69,1526.51,574.82,"increase",2478.2,725,325,400
"1731",2197,7759.19,8803.85,1044.66,"increase",16563.04,4629,2261,2368
"1732",2202,12.16,121.69,109.53,"increase",133.85,64,4,60
"1733",2235,3317.4,2149.28,-1168.12,"increase",5466.68,2021,1253,768
"1734",2326,6802.36,6720.28,-82.0799999999999,"increase",13522.64,4545,2331,2214
"1735",2342,1956.09,1764.78,-191.31,"increase",3720.87,1743,935,808
"1736",2429,0,67.76,67.76,"increase",67.76,14,0,14
"1737",2520,3437.25,4324.04,886.79,"increase",7761.29,2962,1332,1630
"1738",2538,4144.19,5361.95,1217.76,"increase",9506.14,4305,1804,2501
"1739",2562,4194.61,5867.34,1672.73,"increase",10061.95,4150,1742,2408
"1740",2578,5025.76,4987.38,-38.3800000000001,"increase",10013.14,3416,1701,1715
"1741",2643,4887.41,9208.9,4321.49,"increase",14096.31,4193,1633,2560
"1742",2663,7318.06,6663.29,-654.77,"increase",13981.35,4639,2407,2232
"1743",2668,2376.14,2097.39,-278.75,"increase",4473.53,2057,1090,967
"1744",2725,3569.2,3896.6,327.4,"increase",7465.8,3724,1954,1770
"1745",2742,6225.1,6855.56,630.46,"increase",13080.66,3990,2007,1983
"1746",2751,5661.45,5703.41,41.96,"increase",11364.86,5280,2625,2655
"1747",3129,3792.02,4505.39,713.37,"increase",8297.41,3907,1559,2348
"1748",3293,2823.44,2815.93,-7.51000000000022,"increase",5639.37,3066,1529,1537
"1749",3307,4956.28,4877.25,-79.0299999999997,"increase",9833.53,3441,1656,1785
"1750",3348,8650.04,8303.87,-346.17,"increase",16953.91,5522,2727,2795
"1751",3375,2753.13,2773.19,20.0599999999999,"increase",5526.32,2317,1166,1151
"1752",3531,5336.85,5226.67,-110.18,"increase",10563.52,5421,2684,2737
"1753",3546,4021.15,4980.46,959.31,"increase",9001.61,3876,1954,1922
"1754",3560,42.96,0,-42.96,"increase",42.96,4,4,0
"1755",3593,8.38,18.27,9.89,"increase",26.65,6,3,3
"1756",3616,6958.37,7243.87,285.5,"increase",14202.24,4784,2312,2472
"1757",3639,124.92,0,-124.92,"increase",124.92,42,42,0
"1758",3662,3936.06,4496.43,560.37,"increase",8432.49,3077,1423,1654
"1759",3673,4361.27,3909,-452.27,"increase",8270.27,3192,1579,1613
"1760",3743,2939.71,3501.54,561.83,"increase",6441.25,2625,1272,1353
"1761",3765,0,42.2,42.2,"increase",42.2,15,0,15
"1762",3772,8669.72,8346.16,-323.559999999999,"increase",17015.88,5139,2605,2534
"1763",3867,3795.44,4049.98,254.54,"increase",7845.42,2910,1338,1572
"1764",3988,5075.88,4995.77,-80.1099999999997,"increase",10071.65,3805,1994,1811
"1765",4057,3954.3,1333.11,-2621.19,"increase",5287.41,1505,1133,372
"1766",4076,18074.85,7900.77,-10174.08,"increase",25975.62,8445,5387,3058
"1767",4113,3132.22,3703.55,571.33,"increase",6835.77,2579,1210,1369
"1768",4190,4997.69,5724.26,726.57,"increase",10721.95,3434,1639,1795
"1769",4193,6.99,10.78,3.79,"increase",17.77,5,1,4
"1770",4195,3654.37,4315.63,661.26,"increase",7970,2738,1308,1430
"1771",4408,4651.03,4740.09,89.0600000000004,"increase",9391.12,3106,1562,1544
"1772",4795,4427.74,4725.18,297.440000000001,"increase",9152.92,5317,2719,2598
"1773",4799,3671.12,4110.51,439.39,"increase",7781.63,2436,1206,1230
"1774",4930,1995.59,2212.92,217.33,"increase",4208.51,1704,787,917
"1775",4931,3375.7,2243.44,-1132.26,"increase",5619.14,1706,976,730
"1776",4953,0,16.87,16.87,"increase",16.87,4,0,4
"1777",13,6996.4,4644.88,-2351.52,"increase",11641.28,3622,2190,1432
"1778",198,6379.36,5793.27,-586.089999999999,"increase",12172.63,3413,1789,1624
"1779",215,208.56,101.87,-106.69,"increase",310.43,77,50,27
"1780",249,7.21,0,-7.21,"increase",7.21,2,2,0
"1781",326,3851.84,4173.59,321.75,"increase",8025.43,2944,1442,1502
"1782",352,2708.2,2434.1,-274.1,"increase",5142.3,1939,1047,892
"1783",364,116.89,0,-116.89,"increase",116.89,32,32,0
"1784",444,5437.27,5029.08,-408.190000000001,"increase",10466.35,3564,1925,1639
"1785",522,2680.85,2187.57,-493.28,"increase",4868.42,1831,1037,794
"1786",584,4077.41,3673.01,-404.4,"increase",7750.42,3291,1731,1560
"1787",676,15694.12,16200.42,506.299999999999,"increase",31894.54,9034,4587,4447
"1788",795,238.38,0,-238.38,"increase",238.38,73,73,0
"1789",850,2355.91,3033.87,677.96,"increase",5389.78,2391,1123,1268
"1790",951,14.99,0,-14.99,"increase",14.99,1,1,0
"1791",979,10093.91,8731.24,-1362.67,"increase",18825.15,6520,3403,3117
"1792",1005,2522.43,2566.17,43.7400000000002,"increase",5088.6,1817,893,924
"1793",1129,0,3.89,3.89,"increase",3.89,1,0,1
"1794",1172,10122.02,12594.89,2472.87,"increase",22716.91,9006,4192,4814
"1795",1201,6486.94,6387.04,-99.9000000000005,"increase",12873.98,3418,1676,1742
"1796",1213,7503.58,6333.95,-1169.63,"increase",13837.53,4936,2659,2277
"1797",1286,8133.62,7801.28,-332.34,"increase",15934.9,5508,2779,2729
"1798",1326,4332.38,4889.98,557.6,"increase",9222.36,3413,1726,1687
"1799",1444,2232.76,601.57,-1631.19,"increase",2834.33,920,766,154
"1800",1613,2850.36,1631.57,-1218.79,"increase",4481.93,636,329,307
"1801",1619,160.13,0,-160.13,"increase",160.13,77,77,0
"1802",1662,4205.97,5032.71,826.74,"increase",9238.68,4720,2314,2406
"1803",1686,5332.69,6108.9,776.21,"increase",11441.59,4031,1950,2081
"1804",2136,3538.96,4387.7,848.74,"increase",7926.66,2622,1240,1382
"1805",2255,0,63.94,63.94,"increase",63.94,8,0,8
"1806",2457,21.08,0,-21.08,"increase",21.08,8,8,0
"1807",2495,0,183.92,183.92,"increase",183.92,101,0,101
"1808",2697,4137.4,3969.4,-168,"increase",8106.8,2593,1321,1272
"1809",2835,6291.49,5801.9,-489.59,"increase",12093.39,3128,1537,1591
"1810",2837,8499.32,6424.56,-2074.76,"increase",14923.88,6207,3623,2584
"1811",2917,6492.61,5090.89,-1401.72,"increase",11583.5,4010,2106,1904
"1812",3004,0,76.94,76.94,"increase",76.94,25,0,25
"1813",3009,3714.6,3595.64,-118.96,"increase",7310.24,2063,1025,1038
"1814",3094,0,5.49,5.49,"increase",5.49,1,0,1
"1815",3127,7268.42,5393.05,-1875.37,"increase",12661.47,3203,1800,1403
"1816",3295,3071.86,2889.87,-181.99,"increase",5961.73,1496,781,715
"1817",3362,3826.42,3238.22,-588.2,"increase",7064.64,2137,1137,1000
"1818",3482,3850.12,4459.43,609.31,"increase",8309.55,2008,1077,931
"1819",3493,4225.07,4298.46,73.3900000000003,"increase",8523.53,3025,1573,1452
"1820",3559,0,118.73,118.73,"increase",118.73,28,0,28
"1821",3581,852.64,2655.23,1802.59,"increase",3507.87,1262,281,981
"1822",3720,3673.65,1760.71,-1912.94,"increase",5434.36,2334,1566,768
"1823",3726,2120.77,2148.86,28.0900000000001,"increase",4269.63,2453,1282,1171
"1824",3736,6724.75,5827.4,-897.349999999999,"increase",12552.15,4250,2310,1940
"1825",3760,1952.5,2284.12,331.62,"increase",4236.62,1463,653,810
"1826",3806,1.49,543.12,541.63,"increase",544.61,193,1,192
"1827",3869,5318.34,6974.08,1655.74,"increase",12292.42,3527,1578,1949
"1828",3888,0,98.03,98.03,"increase",98.03,34,0,34
"1829",3916,31.05,0,-31.05,"increase",31.05,7,7,0
"1830",4021,9.17,185.33,176.16,"increase",194.5,61,3,58
"1831",4090,0,224.31,224.31,"increase",224.31,19,0,19
"1832",4475,6076.7,6811.13,734.43,"increase",12887.83,3092,1531,1561
"1833",4548,5551.65,4086.26,-1465.39,"increase",9637.91,3262,1803,1459
"1834",4584,4343.37,5018.82,675.45,"increase",9362.19,6348,3046,3302
"1835",4607,9270.27,9492.97,222.699999999999,"increase",18763.24,4804,2240,2564
"1836",4697,5388.58,4718.75,-669.83,"increase",10107.33,4080,2229,1851
"1837",12,211.19,0,-211.19,"increase",211.19,46,46,0
"1838",43,130.24,1276.49,1146.25,"increase",1406.73,648,41,607
"1839",128,4973.68,5561.77,588.09,"increase",10535.45,4607,2218,2389
"1840",169,292.03,246.08,-45.95,"increase",538.11,176,98,78
"1841",210,4285.65,6192.39,1906.74,"increase",10478.04,3055,1386,1669
"1842",250,0,246.1,246.1,"increase",246.1,105,0,105
"1843",264,0,15.47,15.47,"increase",15.47,3,0,3
"1844",278,5447.65,5238.3,-209.35,"increase",10685.95,3093,1597,1496
"1845",323,66.59,0,-66.59,"increase",66.59,9,9,0
"1846",361,19240.99,18076.96,-1164.03,"increase",37317.95,10628,5301,5327
"1847",379,416.23,0,-416.23,"increase",416.23,199,199,0
"1848",394,19.17,0,-19.17,"increase",19.17,6,6,0
"1849",419,0,6.34,6.34,"increase",6.34,5,0,5
"1850",492,21.98,0,-21.98,"increase",21.98,2,2,0
"1851",612,6655.11,6952.91,297.8,"increase",13608.02,3888,1811,2077
"1852",644,4884.27,4551.05,-333.22,"increase",9435.32,2522,1225,1297
"1853",856,3861.12,4639.71,778.59,"increase",8500.83,3025,1388,1637
"1854",933,2781.63,3298.99,517.36,"increase",6080.62,2685,1212,1473
"1855",989,7148.51,7254.37,105.86,"increase",14402.88,4898,2527,2371
"1856",1109,28.67,0,-28.67,"increase",28.67,3,3,0
"1857",1123,0,1.98,1.98,"increase",1.98,2,0,2
"1858",1247,8908.89,7784.92,-1123.97,"increase",16693.81,7750,4164,3586
"1859",1250,6670.5,5867.75,-802.75,"increase",12538.25,3734,2016,1718
"1860",1379,8683.66,6847.51,-1836.15,"increase",15531.17,4989,2788,2201
"1861",1557,9610.21,9317.52,-292.690000000001,"increase",18927.73,6862,3713,3149
"1862",1733,4252.89,3179.88,-1073.01,"increase",7432.77,2319,1297,1022
"1863",1850,3247.16,2990.75,-256.41,"increase",6237.91,2643,1468,1175
"1864",1863,6.69,2.29,-4.4,"increase",8.98,6,4,2
"1865",1901,1180.25,2616.72,1436.47,"increase",3796.97,1267,374,893
"1866",2125,3625.22,4016.15,390.93,"increase",7641.37,1939,915,1024
"1867",2208,24.32,209.36,185.04,"increase",233.68,121,16,105
"1868",2427,50.18,111.41,61.23,"increase",161.59,69,28,41
"1869",2459,0,17.36,17.36,"increase",17.36,9,0,9
"1870",2469,0,91.95,91.95,"increase",91.95,5,0,5
"1871",2505,5113.24,5158.99,45.75,"increase",10272.23,3684,1837,1847
"1872",2532,8955.75,9542.08,586.33,"increase",18497.83,4328,2079,2249
"1873",2534,2014.64,2669.53,654.89,"increase",4684.17,1654,762,892
"1874",2573,3220.09,3764.19,544.1,"increase",6984.28,3550,1672,1878
"1875",2583,3951.05,4006.33,55.2799999999997,"increase",7957.38,2513,1103,1410
"1876",2585,4770.33,4131.45,-638.88,"increase",8901.78,3834,1944,1890
"1877",2589,9238.5,9552.83,314.33,"increase",18791.33,5708,2951,2757
"1878",2634,5072.46,5540.15,467.69,"increase",10612.61,4819,2324,2495
"1879",2690,5669.13,6363.23,694.1,"increase",12032.36,5449,2640,2809
"1880",2733,3996.04,2961.36,-1034.68,"increase",6957.4,2230,1273,957
"1881",2765,483.93,804.97,321.04,"increase",1288.9,440,171,269
"1882",2913,648.95,640.66,-8.29000000000008,"increase",1289.61,430,236,194
"1883",2915,81.15,4.99,-76.16,"increase",86.14,37,36,1
"1884",2983,0,5.78,5.78,"increase",5.78,4,0,4
"1885",3304,5093.91,3578.23,-1515.68,"increase",8672.14,2727,1502,1225
"1886",3315,4006.9,4521,514.1,"increase",8527.9,2788,1302,1486
"1887",3466,8059.64,7466.76,-592.88,"increase",15526.4,4420,2334,2086
"1888",3529,7970.47,9347.84,1377.37,"increase",17318.31,5103,2358,2745
"1889",3599,2431.3,4045.06,1613.76,"increase",6476.36,2058,663,1395
"1890",3681,257.45,0,-257.45,"increase",257.45,73,73,0
"1891",3735,4946.27,6369.46,1423.19,"increase",11315.73,3749,1576,2173
"1892",3787,6332.95,7095.23,762.280000000001,"increase",13428.18,6321,3050,3271
"1893",3793,2000.44,2174.09,173.65,"increase",4174.53,1620,715,905
"1894",3812,2453.68,1742,-711.68,"increase",4195.68,1906,1117,789
"1895",3931,1511.89,982.59,-529.3,"increase",2494.48,1321,821,500
"1896",4040,25,2,-23,"increase",27,4,2,2
"1897",4067,160.55,441.68,281.13,"increase",602.23,233,81,152
"1898",4206,6210.74,5206.45,-1004.29,"increase",11417.19,5520,3050,2470
"1899",4303,3347.61,3673.11,325.5,"increase",7020.72,2256,1168,1088
"1900",4327,9631.83,9304.32,-327.51,"increase",18936.15,5413,2866,2547
"1901",4335,4,0,-4,"increase",4,5,5,0
"1902",4354,5156.85,6034.52,877.67,"increase",11191.37,3644,1629,2015
"1903",4624,7467.86,12704,5236.14,"increase",20171.86,10197,3999,6198
"1904",4845,0,18.52,18.52,"increase",18.52,10,0,10
"1905",391,1.29,0,-1.29,"increase",1.29,1,1,0
"1906",424,3971.51,4403.55,432.04,"increase",8375.06,2886,1402,1484
"1907",445,7810.22,7659.08,-151.14,"increase",15469.3,5008,2664,2344
"1908",467,2787.23,519.47,-2267.76,"increase",3306.7,982,832,150
"1909",578,6471.2,4673.83,-1797.37,"increase",11145.03,5514,3115,2399
"1910",615,4242.85,4631.78,388.929999999999,"increase",8874.63,3569,1764,1805
"1911",645,1671.85,1944.83,272.98,"increase",3616.68,1917,947,970
"1912",665,2637.12,2359.69,-277.43,"increase",4996.81,1967,1013,954
"1913",684,8693.65,7702.68,-990.969999999999,"increase",16396.33,3874,2249,1625
"1914",749,2473.62,2012.61,-461.01,"increase",4486.23,1928,1115,813
"1915",764,3275.95,4774.32,1498.37,"increase",8050.27,2944,1290,1654
"1916",869,3605.98,3144.09,-461.89,"increase",6750.07,2774,1492,1282
"1917",882,4139.57,2438.71,-1700.86,"increase",6578.28,2190,1434,756
"1918",896,16986.06,16853.9,-132.16,"increase",33839.96,13848,6947,6901
"1919",999,6825.78,5867.67,-958.11,"increase",12693.45,4938,2717,2221
"1920",1065,81.18,0,-81.18,"increase",81.18,36,36,0
"1921",1226,4212.18,5085.24,873.059999999999,"increase",9297.42,3095,1413,1682
"1922",1590,4750.03,3997.44,-752.59,"increase",8747.47,3766,2004,1762
"1923",1868,2236.49,2726.75,490.26,"increase",4963.24,2354,1040,1314
"1924",1904,7488.93,8006.94,518.01,"increase",15495.87,5256,2450,2806
"1925",2230,4611.07,5475.33,864.26,"increase",10086.4,4288,2116,2172
"1926",2582,4297.07,3557.42,-739.65,"increase",7854.49,3042,1727,1315
"1927",2623,6379.96,6636.23,256.27,"increase",13016.19,4520,2171,2349
"1928",2817,9193,10890.63,1697.63,"increase",20083.63,7791,3428,4363
"1929",3391,4979.72,4906.87,-72.8500000000004,"increase",9886.59,4014,2069,1945
"1930",3417,2667.76,2928.54,260.78,"increase",5596.3,2032,908,1124
"1931",3420,2056.12,2986.15,930.03,"increase",5042.27,2562,1084,1478
"1932",3422,8973.94,10141.5,1167.56,"increase",19115.44,5642,2594,3048
"1933",4058,3.59,0,-3.59,"increase",3.59,1,1,0
"1934",4112,4399.58,4636.39,236.81,"increase",9035.97,3414,1598,1816
"1935",4477,3788.91,5077.28,1288.37,"increase",8866.19,2819,1233,1586
"1936",4944,5378.76,4445.6,-933.16,"increase",9824.36,3622,1993,1629
"1937",330,6703.67,7000.64,296.97,"increase",13704.31,5344,2775,2569
"1938",488,5056.01,4871.6,-184.41,"increase",9927.61,3011,1537,1474
"1939",935,11279.8,12827.52,1547.72,"increase",24107.32,8078,3797,4281
"1940",1125,75.37,112.78,37.41,"increase",188.15,69,30,39
"1941",1504,635.7,650.61,14.91,"increase",1286.31,351,161,190
"1942",2975,3588.99,4195.18,606.19,"increase",7784.17,3342,1591,1751
"1943",4937,5880.36,6025.08,144.72,"increase",11905.44,3858,1893,1965
"1944",35,23.73,133,109.27,"increase",156.73,61,10,51
"1945",93,24.74,48.86,24.12,"increase",73.6,34,6,28
"1946",103,6822.13,6860.07,37.9399999999996,"increase",13682.2,4128,2154,1974
"1947",117,7156.56,8832.33,1675.77,"increase",15988.89,6545,2874,3671
"1948",133,0,21.98,21.98,"increase",21.98,2,0,2
"1949",203,0,28.55,28.55,"increase",28.55,7,0,7
"1950",303,3021.17,351.88,-2669.29,"increase",3373.05,1416,1298,118
"1951",305,2675.32,2223.01,-452.31,"increase",4898.33,2372,1254,1118
"1952",320,6313.27,5910.78,-402.490000000001,"increase",12224.05,3596,1809,1787
"1953",529,3508.23,4863.85,1355.62,"increase",8372.08,2857,1331,1526
"1954",536,3391.76,4474.65,1082.89,"increase",7866.41,2291,1163,1128
"1955",609,4642.03,5778.45,1136.42,"increase",10420.48,4341,2018,2323
"1956",674,1954.58,2313.31,358.73,"increase",4267.89,3464,1704,1760
"1957",690,3772.21,3490.98,-281.23,"increase",7263.19,4129,2047,2082
"1958",753,3370.6,3119.92,-250.68,"increase",6490.52,2481,1254,1227
"1959",767,5239.24,7195.82,1956.58,"increase",12435.06,4168,1711,2457
"1960",769,3395.25,3478.84,83.5900000000001,"increase",6874.09,2134,1063,1071
"1961",775,7531.05,5711.98,-1819.07,"increase",13243.03,4082,2376,1706
"1962",779,2291.9,3025.41,733.51,"increase",5317.31,2866,1302,1564
"1963",829,2138.28,2038.89,-99.3900000000001,"increase",4177.17,2246,1174,1072
"1964",832,4441.41,4413.97,-27.4399999999996,"increase",8855.38,3683,1879,1804
"1965",849,9408.5,10462.79,1054.29,"increase",19871.29,8159,3953,4206
"1966",858,8122.09,8710.46,588.370000000001,"increase",16832.55,7657,3665,3992
"1967",864,901.13,1405.8,504.67,"increase",2306.93,1186,482,704
"1968",1121,14.53,0,-14.53,"increase",14.53,7,7,0
"1969",1137,11.47,0,-11.47,"increase",11.47,6,6,0
"1970",1141,4882.48,6331.58,1449.1,"increase",11214.06,2955,1375,1580
"1971",1261,3359.06,3646.02,286.96,"increase",7005.08,1994,970,1024
"1972",1306,3935.52,4090,154.48,"increase",8025.52,4391,2108,2283
"1973",1372,2631.58,3289.48,657.9,"increase",5921.06,2931,1300,1631
"1974",1408,9590.59,10017.32,426.73,"increase",19607.91,6220,2964,3256
"1975",1492,2961.85,1354.54,-1607.31,"increase",4316.39,1281,905,376
"1976",1646,6131.4,4758.35,-1373.05,"increase",10889.75,3144,1748,1396
"1977",1703,3536.82,4894.64,1357.82,"increase",8431.46,2487,1021,1466
"1978",1948,3622.54,3441.64,-180.9,"increase",7064.18,2279,1185,1094
"1979",2056,4522.5,4845.78,323.28,"increase",9368.28,2423,1179,1244
"1980",2341,0,61.51,61.51,"increase",61.51,18,0,18
"1981",2357,3535.76,5854.97,2319.21,"increase",9390.73,3474,1220,2254
"1982",2381,3299.19,4371.72,1072.53,"increase",7670.91,2685,1178,1507
"1983",2422,2726.74,2151.92,-574.82,"increase",4878.66,1921,1049,872
"1984",2488,2545.91,2731.12,185.21,"increase",5277.03,1989,1062,927
"1985",2555,0,512.62,512.62,"increase",512.62,170,0,170
"1986",2576,7191.39,7044.87,-146.52,"increase",14236.26,4687,2397,2290
"1987",2661,8504.23,6033.06,-2471.17,"increase",14537.29,4796,2862,1934
"1988",2662,4457.63,4495.39,37.7600000000002,"increase",8953.02,2909,1434,1475
"1989",2753,2824.13,3303.16,479.03,"increase",6127.29,2459,1162,1297
"1990",2763,12046.26,8220.65,-3825.61,"increase",20266.91,4255,2480,1775
"1991",2806,3344.04,1517.06,-1826.98,"increase",4861.1,1965,1390,575
"1992",2808,2596.74,2754.85,158.11,"increase",5351.59,4079,1727,2352
"1993",2850,2628.39,3118,489.61,"increase",5746.39,2636,1229,1407
"1994",2857,9220.79,11172.77,1951.98,"increase",20393.56,9156,4204,4952
"1995",2880,3151.31,3296.24,144.93,"increase",6447.55,2173,1096,1077
"1996",2994,40.39,0,-40.39,"increase",40.39,19,19,0
"1997",3076,4815.65,5060.26,244.610000000001,"increase",9875.91,3017,1437,1580
"1998",3088,1891.95,2740.89,848.94,"increase",4632.84,1762,701,1061
"1999",3140,5374.34,5783.09,408.75,"increase",11157.43,3827,1973,1854
"2000",3177,56.9,0,-56.9,"increase",56.9,11,11,0
"2001",3194,3973.16,4046.33,73.1700000000001,"increase",8019.49,2177,1123,1054
"2002",3219,16.25,0,-16.25,"increase",16.25,8,8,0
"2003",3224,0,77.01,77.01,"increase",77.01,30,0,30
"2004",3244,87.03,0,-87.03,"increase",87.03,14,14,0
"2005",3387,132.4,107.41,-24.99,"increase",239.81,88,52,36
"2006",3614,2987.84,2792.97,-194.87,"increase",5780.81,2202,1151,1051
"2007",3622,3537,3081.32,-455.68,"increase",6618.32,2775,1525,1250
"2008",3738,4912.59,4867.58,-45.0100000000002,"increase",9780.17,2938,1416,1522
"2009",3868,5956.75,5067.14,-889.61,"increase",11023.89,3878,2185,1693
"2010",3880,2721.79,2261.19,-460.6,"increase",4982.98,2148,1118,1030
"2011",3902,60.8,0,-60.8,"increase",60.8,18,18,0
"2012",4099,0,4.99,4.99,"increase",4.99,3,0,3
"2013",4376,2443.26,3423.1,979.84,"increase",5866.36,2371,1087,1284
"2014",4470,0,2.61,2.61,"increase",2.61,3,0,3
"2015",4802,1674.45,1451.44,-223.01,"increase",3125.89,1436,723,713
"2016",4973,188.3,86.03,-102.27,"increase",274.33,141,81,60
"2017",37,0,17.98,17.98,"increase",17.98,12,0,12
"2018",52,6.78,0,-6.78,"increase",6.78,3,3,0
"2019",53,132.66,35.96,-96.7,"increase",168.62,25,21,4
"2020",107,0,17.18,17.18,"increase",17.18,2,0,2
"2021",254,0,17.98,17.98,"increase",17.98,3,0,3
"2022",316,0,31.67,31.67,"increase",31.67,13,0,13
"2023",441,6743.24,5931.12,-812.12,"increase",12674.36,4807,2560,2247
"2024",446,0,9.38,9.38,"increase",9.38,2,0,2
"2025",450,145.1,367.81,222.71,"increase",512.91,200,54,146
"2026",451,145.1,367.81,222.71,"increase",512.91,200,54,146
"2027",456,4139.41,3573.25,-566.16,"increase",7712.66,3195,1803,1392
"2028",496,7.99,0,-7.99,"increase",7.99,2,2,0
"2029",638,1575.5,2276.81,701.31,"increase",3852.31,1830,769,1061
"2030",641,2746.28,2062.46,-683.82,"increase",4808.74,1655,941,714
"2031",962,4098.11,3743.03,-355.079999999999,"increase",7841.14,4847,2519,2328
"2032",1045,83.27,0,-83.27,"increase",83.27,17,17,0
"2033",1082,26.7,360.16,333.46,"increase",386.86,192,18,174
"2034",1089,0,17.5,17.5,"increase",17.5,6,0,6
"2035",1215,5913.72,6215.64,301.92,"increase",12129.36,4199,2116,2083
"2036",1230,3366.63,3108.02,-258.61,"increase",6474.65,2061,1094,967
"2037",1414,6570.64,6090.61,-480.030000000001,"increase",12661.25,4042,2070,1972
"2038",1415,3199.49,2679.82,-519.67,"increase",5879.31,1421,765,656
"2039",1527,2999.67,981.82,-2017.85,"increase",3981.49,1165,881,284
"2040",1591,3503.74,2598.98,-904.76,"increase",6102.72,2096,1183,913
"2041",1680,4531.76,4615.46,83.6999999999998,"increase",9147.22,4019,2039,1980
"2042",1920,2951.49,3285.42,333.93,"increase",6236.91,2431,1155,1276
"2043",1939,2366.74,2987.88,621.14,"increase",5354.62,1870,842,1028
"2044",2106,2589.64,3479.55,889.91,"increase",6069.19,2449,1019,1430
"2045",2126,3012.08,4655.13,1643.05,"increase",7667.21,2132,847,1285
"2046",2250,2593.99,2330.18,-263.81,"increase",4924.17,2070,1106,964
"2047",2343,2891.14,2881.72,-9.41999999999962,"increase",5772.86,2771,1404,1367
"2048",2411,0,24.16,24.16,"increase",24.16,17,0,17
"2049",2568,6828.28,7050.98,222.700000000001,"increase",13879.26,3552,1839,1713
"2050",2629,2323.81,2983.25,659.44,"increase",5307.06,2591,1178,1413
"2051",2710,4887.17,5340.66,453.49,"increase",10227.83,4480,2112,2368
"2052",2978,5971.62,7846.91,1875.29,"increase",13818.53,4564,2000,2564
"2053",3008,27.18,8.16,-19.02,"increase",35.34,12,8,4
"2054",3274,55.58,0,-55.58,"increase",55.58,12,12,0
"2055",3341,1808.3,2335.04,526.74,"increase",4143.34,1868,824,1044
"2056",3413,3355.7,2933.93,-421.77,"increase",6289.63,1978,1061,917
"2057",3439,1419.59,1425.34,5.75,"increase",2844.93,1484,728,756
"2058",3488,879.34,991.92,112.58,"increase",1871.26,1086,541,545
"2059",3503,4321.03,3798.51,-522.52,"increase",8119.54,3047,1635,1412
"2060",3530,2002.55,1819.94,-182.61,"increase",3822.49,1044,568,476
"2061",3660,4981.69,4850.22,-131.469999999999,"increase",9831.91,3293,1654,1639
"2062",3774,152.94,70.84,-82.1,"increase",223.78,79,55,24
"2063",3804,8513.79,9375.88,862.089999999998,"increase",17889.67,4538,2221,2317
"2064",4066,0,58.58,58.58,"increase",58.58,20,0,20
"2065",4142,579.18,469.55,-109.63,"increase",1048.73,357,219,138
"2066",4366,494.42,2914.79,2420.37,"increase",3409.21,1852,253,1599
"2067",4418,2108.45,1721.31,-387.14,"increase",3829.76,1075,590,485
"2068",4521,3855.54,4477.34,621.8,"increase",8332.88,2242,1120,1122
"2069",139,7896.01,7317.51,-578.5,"increase",15213.52,4398,2214,2184
"2070",868,2106.56,1160.23,-946.33,"increase",3266.79,1527,1012,515
"2071",1078,3.49,298.9,295.41,"increase",302.39,92,1,91
"2072",1087,0,31.92,31.92,"increase",31.92,6,0,6
"2073",1103,1652.18,2371.04,718.86,"increase",4023.22,1471,548,923
"2074",1114,477.68,2752.21,2274.53,"increase",3229.89,1085,165,920
"2075",1480,8892.85,8772.58,-120.27,"increase",17665.43,6008,3034,2974
"2076",1514,4816.88,4046.97,-769.91,"increase",8863.85,2517,1432,1085
"2077",1620,3393.41,3576.83,183.42,"increase",6970.24,2465,1158,1307
"2078",2064,49.08,0,-49.08,"increase",49.08,22,22,0
"2079",2409,273.28,116.93,-156.35,"increase",390.21,76,47,29
"2080",3334,4980.19,4804.88,-175.31,"increase",9785.07,3459,1759,1700
"2081",3452,3119.13,4121.47,1002.34,"increase",7240.6,2864,1333,1531
"2082",3474,2329.34,3351.71,1022.37,"increase",5681.05,1699,705,994
"2083",3506,7031.15,6378.05,-653.099999999999,"increase",13409.2,3456,1766,1690
"2084",3665,1054.06,717.99,-336.07,"increase",1772.05,568,345,223
"2085",337,8083.13,8033.51,-49.6199999999999,"increase",16116.64,6451,3382,3069
"2086",685,2015.61,2590.95,575.34,"increase",4606.56,2886,1292,1594
"2087",1183,4727.51,2600.83,-2126.68,"increase",7328.34,2570,1669,901
"2088",1366,6741.56,6852.81,111.25,"increase",13594.37,3913,1870,2043
"2089",1413,9932.92,7967.94,-1964.98,"increase",17900.86,5347,2882,2465
"2090",2261,2896.44,3281.89,385.45,"increase",6178.33,1685,802,883
"2091",2483,4768.03,4493.43,-274.599999999999,"increase",9261.46,2712,1341,1371
"2092",2632,7631.31,6938.87,-692.440000000001,"increase",14570.18,4050,2064,1986
"2093",2756,13.05,0,-13.05,"increase",13.05,6,6,0
"2094",2830,6209.69,5754.85,-454.84,"increase",11964.54,2734,1549,1185
"2095",3762,7583.34,6976.99,-606.35,"increase",14560.33,3932,2156,1776
"2096",3784,9166.22,6611.64,-2554.58,"increase",15777.86,5018,2863,2155
"2097",3859,6900.38,8805.57,1905.19,"increase",15705.95,6219,2651,3568
"2098",3961,4819.36,5345.4,526.04,"increase",10164.76,2224,1124,1100
"2099",3968,3957.07,2980.7,-976.37,"increase",6937.77,3232,1743,1489
"2100",4183,1901.92,2487.37,585.45,"increase",4389.29,957,430,527
"2101",22,3060.39,2928.98,-131.41,"increase",5989.37,2310,1175,1135
"2102",26,13.79,0,-13.79,"increase",13.79,1,1,0
"2103",36,4320.37,3945.94,-374.43,"increase",8266.31,2532,1355,1177
"2104",155,6508.81,6328.24,-180.570000000001,"increase",12837.05,4339,2276,2063
"2105",205,9.18,0,-9.18,"increase",9.18,3,3,0
"2106",211,0,26.43,26.43,"increase",26.43,15,0,15
"2107",236,3.98,0,-3.98,"increase",3.98,2,2,0
"2108",251,19.17,231.19,212.02,"increase",250.36,72,3,69
"2109",255,0,248.21,248.21,"increase",248.21,67,0,67
"2110",263,32.7,13.98,-18.72,"increase",46.68,17,13,4
"2111",288,2360.81,2301.75,-59.0599999999999,"increase",4662.56,2280,1153,1127
"2112",356,139.64,8.94,-130.7,"increase",148.58,73,67,6
"2113",587,973.54,905.38,-68.16,"increase",1878.92,1127,593,534
"2114",594,5457.47,4262.16,-1195.31,"increase",9719.63,4350,2364,1986
"2115",613,3351.44,3265.93,-85.5100000000002,"increase",6617.37,2532,1333,1199
"2116",719,2672.94,2617.48,-55.46,"increase",5290.42,2201,1314,887
"2117",757,4179.24,4408.55,229.31,"increase",8587.79,3095,1525,1570
"2118",761,5027.41,5014.56,-12.8499999999995,"increase",10041.97,2832,1421,1411
"2119",792,8659.6,9621.25,961.65,"increase",18280.85,4669,2402,2267
"2120",816,1508.36,2208.51,700.15,"increase",3716.87,1041,551,490
"2121",879,13078.63,11342.34,-1736.29,"increase",24420.97,7864,4091,3773
"2122",884,1824.75,2099.23,274.48,"increase",3923.98,1452,643,809
"2123",905,5214.81,5904.49,689.679999999999,"increase",11119.3,3142,1580,1562
"2124",939,6372.92,6360.64,-12.2799999999997,"increase",12733.56,5983,3026,2957
"2125",955,4451.14,3182.17,-1268.97,"increase",7633.31,3457,1941,1516
"2126",1011,6148.17,5715.36,-432.81,"increase",11863.53,4554,2315,2239
"2127",1015,2225.39,1873.29,-352.1,"increase",4098.68,1368,758,610
"2128",1059,1782.63,2579.22,796.59,"increase",4361.85,1922,767,1155
"2129",1067,4902.83,5199.6,296.77,"increase",10102.43,3611,2027,1584
"2130",1069,0,10,10,"increase",10,3,0,3
"2131",1085,90.87,108.28,17.41,"increase",199.15,83,48,35
"2132",1176,2206.68,2786.77,580.09,"increase",4993.45,1623,735,888
"2133",1177,3092.87,4629.84,1536.97,"increase",7722.71,2692,1003,1689
"2134",1181,5163.92,5282.9,118.98,"increase",10446.82,3757,1900,1857
"2135",1195,1858.25,1816.88,-41.3699999999999,"increase",3675.13,1747,915,832
"2136",1224,2944.85,3531.92,587.07,"increase",6476.77,2061,967,1094
"2137",1248,3482.93,2978.08,-504.85,"increase",6461.01,2789,1554,1235
"2138",1264,306.8,969.45,662.65,"increase",1276.25,513,103,410
"2139",1268,3166.58,3056.25,-110.33,"increase",6222.83,2918,1542,1376
"2140",1274,2375.58,3860.1,1484.52,"increase",6235.68,2237,878,1359
"2141",1305,2988.58,3976.38,987.8,"increase",6964.96,2819,1309,1510
"2142",1387,8423.24,10124.26,1701.02,"increase",18547.5,8415,4159,4256
"2143",1436,4454.53,5583.54,1129.01,"increase",10038.07,3782,1702,2080
"2144",1440,2614.42,2751.2,136.78,"increase",5365.62,2055,1019,1036
"2145",1446,4927.12,5720.1,792.98,"increase",10647.22,3507,1709,1798
"2146",1449,6292.05,7333.23,1041.18,"increase",13625.28,4429,2085,2344
"2147",1593,53.31,141.52,88.21,"increase",194.83,40,18,22
"2148",1688,0,24.23,24.23,"increase",24.23,8,0,8
"2149",1699,9402.12,7519.78,-1882.34,"increase",16921.9,6848,3812,3036
"2150",1709,4472.34,3992.01,-480.33,"increase",8464.35,4329,2285,2044
"2151",1783,2281.53,1636.37,-645.16,"increase",3917.9,1316,778,538
"2152",1791,8441.53,9632.29,1190.76,"increase",18073.82,8633,3854,4779
"2153",1813,21.31,254.48,233.17,"increase",275.79,83,14,69
"2154",1820,5144.01,4057.17,-1086.84,"increase",9201.18,3477,1907,1570
"2155",2060,453.17,30.52,-422.65,"increase",483.69,166,156,10
"2156",2061,2736.74,2582.86,-153.88,"increase",5319.6,3727,1996,1731
"2157",2129,3943.91,3328.8,-615.11,"increase",7272.71,2124,1129,995
"2158",2157,2430.62,1888.47,-542.15,"increase",4319.09,1849,969,880
"2159",2199,4598.85,8138.23,3539.38,"increase",12737.08,3987,1583,2404
"2160",2290,4575.95,4475.34,-100.61,"increase",9051.29,3758,1911,1847
"2161",2297,29.24,0,-29.24,"increase",29.24,13,13,0
"2162",2355,3701.79,3966.61,264.82,"increase",7668.4,4082,2087,1995
"2163",2388,9.47,0,-9.47,"increase",9.47,3,3,0
"2164",2397,1698.24,1884.67,186.43,"increase",3582.91,1422,653,769
"2165",2447,17.46,0,-17.46,"increase",17.46,4,4,0
"2166",2458,1652.8,1744.89,92.0900000000001,"increase",3397.69,1530,774,756
"2167",2509,2059.9,1890.58,-169.32,"increase",3950.48,1621,846,775
"2168",2513,2898.82,2083.16,-815.66,"increase",4981.98,2123,1259,864
"2169",2588,22.27,0,-22.27,"increase",22.27,10,10,0
"2170",2626,3943.98,3875.64,-68.3400000000001,"increase",7819.62,2603,1277,1326
"2171",2721,2170.8,2140.51,-30.29,"increase",4311.31,1829,1017,812
"2172",2735,2304.97,2885.16,580.19,"increase",5190.13,2006,920,1086
"2173",2770,12249.37,10844.39,-1404.98,"increase",23093.76,6688,3468,3220
"2174",2802,3674.05,4253.11,579.059999999999,"increase",7927.16,3403,1538,1865
"2175",2861,5474.55,4456.45,-1018.1,"increase",9931,4626,2662,1964
"2176",2882,4127.59,4425.53,297.94,"increase",8553.12,2754,1351,1403
"2177",2890,11901.62,14044.26,2142.64,"increase",25945.88,8385,3820,4565
"2178",2906,9473.31,14201.02,4727.71,"increase",23674.33,9731,3983,5748
"2179",2934,5763.89,5943.98,180.09,"increase",11707.87,3100,1558,1542
"2180",2974,2979.42,2598.51,-380.91,"increase",5577.93,1871,940,931
"2181",3002,2604.64,2141.55,-463.09,"increase",4746.19,2004,1081,923
"2182",3038,3975.53,4121.5,145.97,"increase",8097.03,3036,1523,1513
"2183",3171,676.8,1601.77,924.97,"increase",2278.57,1091,312,779
"2184",3202,3.5,0,-3.5,"increase",3.5,3,3,0
"2185",3281,3064.21,1814.81,-1249.4,"increase",4879.02,1959,1296,663
"2186",3286,94.07,0,-94.07,"increase",94.07,31,31,0
"2187",3291,8.25,0,-8.25,"increase",8.25,3,3,0
"2188",3298,1246.91,1123.46,-123.45,"increase",2370.37,1374,710,664
"2189",3337,1820.82,1956.35,135.53,"increase",3777.17,1381,639,742
"2190",3378,5215.71,7714.69,2498.98,"increase",12930.4,4070,1684,2386
"2191",3397,2708.31,2844.27,135.96,"increase",5552.58,2636,1273,1363
"2192",3458,4260.48,4924.09,663.61,"increase",9184.57,2055,909,1146
"2193",3467,2876.54,3354.03,477.49,"increase",6230.57,3128,1500,1628
"2194",3510,3386.96,2365.11,-1021.85,"increase",5752.07,2366,1370,996
"2195",3539,7979.11,4442.95,-3536.16,"increase",12422.06,3657,2258,1399
"2196",3615,1864.55,2553.32,688.77,"increase",4417.87,1700,731,969
"2197",3624,2598.15,4181.3,1583.15,"increase",6779.45,2882,1297,1585
"2198",3645,93.43,0,-93.43,"increase",93.43,34,34,0
"2199",3700,5619.91,6174.14,554.23,"increase",11794.05,5063,2448,2615
"2200",3728,1358.21,2089.12,730.91,"increase",3447.33,1477,621,856
"2201",3749,2356.05,2278.57,-77.48,"increase",4634.62,2129,1111,1018
"2202",3817,8249.16,8576.52,327.360000000001,"increase",16825.68,4711,2385,2326
"2203",3821,0,120.78,120.78,"increase",120.78,42,0,42
"2204",3866,3142.33,4021.38,879.05,"increase",7163.71,2275,1163,1112
"2205",3976,5175.31,5369.31,194,"increase",10544.62,3580,1780,1800
"2206",3991,4642.84,4619.41,-23.4300000000003,"increase",9262.25,4108,2071,2037
"2207",4008,5256.07,5411.72,155.650000000001,"increase",10667.79,4131,2066,2065
"2208",4324,3099.64,3041.99,-57.6499999999996,"increase",6141.63,2946,1501,1445
"2209",4405,3785.34,4858.28,1072.94,"increase",8643.62,3031,1340,1691
"2210",4459,4604.78,5266.53,661.75,"increase",9871.31,3778,1749,2029
"2211",4549,3770.27,4482.75,712.48,"increase",8253.02,2676,1288,1388
"2212",4588,4094.57,3761.69,-332.88,"increase",7856.26,3316,1663,1653
"2213",4623,7.68,0,-7.68,"increase",7.68,4,4,0
"2214",4627,35.66,72.54,36.88,"increase",108.2,35,15,20
"2215",4628,4008.07,3110.07,-898,"increase",7118.14,2857,1597,1260
"2216",4788,4720.29,4000.46,-719.83,"increase",8720.75,2403,1287,1116
"2217",4813,3360.7,2955.07,-405.63,"increase",6315.77,2247,1203,1044
"2218",4829,140.6,80.23,-60.37,"increase",220.83,37,20,17
"2219",4926,3193.27,4359.6,1166.33,"increase",7552.87,3278,1444,1834
"2220",4964,3409.88,1612.44,-1797.44,"increase",5022.32,1753,1144,609
"2221",1630,5390.89,7996.66,2605.77,"increase",13387.55,4031,1642,2389
"2222",1669,2344.22,3616.49,1272.27,"increase",5960.71,1758,789,969
"2223",1797,44.71,190.26,145.55,"increase",234.97,88,18,70
"2224",1448,3717.66,5153.9,1436.24,"increase",8871.56,3115,1250,1865
"2225",4816,9966.84,9982.53,15.6900000000005,"increase",19949.37,5171,2532,2639
"2226",4870,0,46.92,46.92,"increase",46.92,18,0,18
"2227",1959,9188,7587.22,-1600.78,"increase",16775.22,6185,3449,2736
"2228",695,4133.5,4545.53,412.03,"increase",8679.03,2684,1337,1347
"2229",1546,11240.68,6795.24,-4445.44,"increase",18035.92,5317,3164,2153
"2230",1906,5985.75,1534.66,-4451.09,"increase",7520.41,2387,1976,411
"2231",3620,8247.79,6453.09,-1794.7,"increase",14700.88,4966,2661,2305
"2232",966,2975.54,2137.51,-838.03,"increase",5113.05,2617,1493,1124
"2233",2385,3132.34,3477.87,345.53,"increase",6610.21,3093,1586,1507
"2234",4258,3676,4232.79,556.79,"increase",7908.79,2624,1226,1398
"2235",131,12.32,0,-12.32,"increase",12.32,7,7,0
"2236",1893,4470.56,3483.66,-986.900000000001,"increase",7954.22,2644,1575,1069
"2237",2324,2265.13,1472.92,-792.21,"increase",3738.05,1495,1002,493
"2238",2442,5118.03,4700.79,-417.24,"increase",9818.82,3485,1795,1690
"2239",3592,3668.23,4221.01,552.78,"increase",7889.24,2772,1215,1557
"2240",3276,5872.83,5904.33,31.5,"increase",11777.16,3082,1571,1511
"2241",174,9.95,0,-9.95,"increase",9.95,5,5,0
"2242",542,3010.23,2634.66,-375.57,"increase",5644.89,3510,1894,1616
"2243",570,2475.84,2649.31,173.47,"increase",5125.15,1831,931,900
"2244",836,3489.33,3846.35,357.02,"increase",7335.68,2479,1106,1373
"2245",847,3746.6,6095.58,2348.98,"increase",9842.18,5207,1901,3306
"2246",926,22.42,192.99,170.57,"increase",215.41,62,9,53
"2247",1190,3431.96,3284.22,-147.74,"increase",6716.18,1977,1020,957
"2248",2038,2482.74,2341.91,-140.83,"increase",4824.65,1360,657,703
"2249",2665,4129.71,4343.67,213.96,"increase",8473.38,2576,1148,1428
"2250",2833,4503.07,5143.28,640.21,"increase",9646.35,2929,1359,1570
"2251",2968,671.74,1103.61,431.87,"increase",1775.35,658,216,442
"2252",3505,635.95,639.88,3.92999999999995,"increase",1275.83,437,216,221
"2253",4102,5270.15,5496.89,226.740000000001,"increase",10767.04,4135,1985,2150
"2254",4203,3402.73,3217.62,-185.11,"increase",6620.35,2684,1368,1316
"2255",4494,11.99,0,-11.99,"increase",11.99,2,2,0
"2256",4713,4965.55,4498.82,-466.73,"increase",9464.37,3376,1847,1529
"2257",3881,5681.06,4077.95,-1603.11,"increase",9759.01,3063,1688,1375
"2258",4715,3828.86,6493.99,2665.13,"increase",10322.85,3010,1136,1874
"2259",3254,623.97,725.48,101.51,"increase",1349.45,701,287,414
"2260",4765,6354.49,4442.49,-1912,"increase",10796.98,3628,2078,1550
"2261",70,7535.92,8526.22,990.299999999999,"increase",16062.14,5874,2780,3094
"2262",4677,5441.16,5096.5,-344.66,"increase",10537.66,5332,2739,2593
"2263",2395,181.94,0,-181.94,"increase",181.94,6,6,0
"2264",1467,1738.97,1778.81,39.8399999999999,"increase",3517.78,1605,692,913
"2265",4222,17.24,0,-17.24,"increase",17.24,8,8,0
"2266",4502,6412.37,6177.7,-234.67,"increase",12590.07,3614,1806,1808
"2267",1663,4927.82,5796.68,868.860000000001,"increase",10724.5,3727,1652,2075
"2268",4159,6684.79,7454.87,770.08,"increase",14139.66,5254,2541,2713
"2269",1610,0,11.83,11.83,"increase",11.83,5,0,5
"2270",3545,8073.8,7904.36,-169.44,"increase",15978.16,6028,3101,2927
"2271",4281,9576.77,8344.82,-1231.95,"increase",17921.59,5644,2812,2832
"2272",4358,6268.1,4006.94,-2261.16,"increase",10275.04,3822,2450,1372
"2273",4593,6547.98,8867.39,2319.41,"increase",15415.37,6129,2725,3404
"2274",24,13900.48,20793.01,6892.53,"increase",34693.49,12868,5108,7760
"2275",1037,3758.67,1792.56,-1966.11,"increase",5551.23,2767,1890,877
"2276",1049,842.58,1254.23,411.65,"increase",2096.81,791,303,488
"2277",1343,14150.16,15362.34,1212.18,"increase",29512.5,11444,5230,6214
"2278",1422,68.65,179.81,111.16,"increase",248.46,113,39,74
"2279",1776,1426.19,1722.33,296.14,"increase",3148.52,1235,594,641
"2280",1977,6.72,0,-6.72,"increase",6.72,4,4,0
"2281",1978,2589.54,2741.85,152.31,"increase",5331.39,2393,1071,1322
"2282",2022,5770.48,6035.16,264.679999999999,"increase",11805.64,3682,1906,1776
"2283",2059,2958.44,3946.46,988.02,"increase",6904.9,3098,1357,1741
"2284",2159,3768.29,3375.19,-393.1,"increase",7143.48,2471,1355,1116
"2285",2245,3100.02,2905.14,-194.88,"increase",6005.16,4042,2020,2022
"2286",3070,4383.63,4915.98,532.35,"increase",9299.61,3333,1578,1755
"2287",3191,2554.57,2406.09,-148.48,"increase",4960.66,1869,907,962
"2288",3498,4301.12,3892.35,-408.77,"increase",8193.47,2184,1165,1019
"2289",3557,1613.5,2215.68,602.18,"increase",3829.18,1570,626,944
"2290",3617,4140.49,4163.93,23.4400000000005,"increase",8304.42,4418,2177,2241
"2291",3740,1798.14,1407.29,-390.85,"increase",3205.43,1288,640,648
"2292",4444,4189.37,2634.65,-1554.72,"increase",6824.02,2149,1321,828
"2293",4610,4839.25,4466.95,-372.3,"increase",9306.2,3838,1980,1858
"2294",4897,2763.7,2473.32,-290.38,"increase",5237.02,1661,821,840
"2295",98,1675.75,1020.65,-655.1,"increase",2696.4,789,486,303
"2296",116,16.37,0,-16.37,"increase",16.37,6,6,0
"2297",523,0,14.44,14.44,"increase",14.44,6,0,6
"2298",559,5413.51,4626.82,-786.690000000001,"increase",10040.33,3656,1986,1670
"2299",1603,2400.29,3575.3,1175.01,"increase",5975.59,1874,869,1005
"2300",1725,5141.44,4299.52,-841.919999999999,"increase",9440.96,3061,1634,1427
"2301",1795,0,32.46,32.46,"increase",32.46,11,0,11
"2302",2226,1414.25,2247.1,832.85,"increase",3661.35,1193,439,754
"2303",2236,0,2.5,2.5,"increase",2.5,1,0,1
"2304",2258,2514.82,2016.75,-498.07,"increase",4531.57,2640,1502,1138
"2305",2282,14338.71,14844.47,505.759999999998,"increase",29183.18,8157,3985,4172
"2306",2328,7452.33,9731,2278.67,"increase",17183.33,5820,2548,3272
"2307",3240,65.37,114.1,48.73,"increase",179.47,49,21,28
"2308",3429,3273.49,3217.59,-55.9000000000001,"increase",6491.08,2644,1375,1269
"2309",3841,4040.77,3692.78,-347.99,"increase",7733.55,3092,1627,1465
"2310",4393,43.47,0,-43.47,"increase",43.47,12,12,0
"2311",4898,2529.95,5083.38,2553.43,"increase",7613.33,3531,1142,2389
"2312",68,4879.46,4123.54,-755.92,"increase",9003,2224,1247,977
"2313",670,8281.4,10053.5,1772.1,"increase",18334.9,5753,2482,3271
"2314",1156,21.17,0,-21.17,"increase",21.17,5,5,0
"2315",2404,4392.96,5198.58,805.62,"increase",9591.54,4012,1803,2209
"2316",3610,6664.7,8236.16,1571.46,"increase",14900.86,5573,2491,3082
"2317",3960,3019.18,2378.42,-640.76,"increase",5397.6,1814,968,846
"2318",4069,356.72,26.97,-329.75,"increase",383.69,107,102,5
"2319",4430,5896.29,5926.75,30.46,"increase",11823.04,3403,1764,1639
"2320",4618,5249.03,4884.68,-364.349999999999,"increase",10133.71,2842,1384,1458
"2321",4878,8200.9,6104.9,-2096,"increase",14305.8,4155,2453,1702
"2322",713,5593.51,4855.59,-737.92,"increase",10449.1,3711,1908,1803
"2323",2336,45.67,13.55,-32.12,"increase",59.22,19,13,6
"2324",3453,41.78,63.66,21.88,"increase",105.44,36,19,17
"2325",3632,1919.44,1836.42,-83.02,"increase",3755.86,1176,676,500
"2326",4083,5253.42,5182.9,-70.5199999999995,"increase",10436.32,3784,1958,1826
"2327",4945,7020.72,3939.19,-3081.53,"increase",10959.91,3773,2458,1315
"2328",2028,198.32,397.29,198.97,"increase",595.61,240,64,176
"2329",2232,2340.65,1897.88,-442.77,"increase",4238.53,1934,1110,824
"2330",2368,1827.66,3115.91,1288.25,"increase",4943.57,1991,853,1138
"2331",4248,1386.49,1292.96,-93.53,"increase",2679.45,1203,495,708
"2332",4435,6184.28,4582.76,-1601.52,"increase",10767.04,3494,1914,1580
"2333",2212,6835.69,4952.24,-1883.45,"increase",11787.93,2933,1683,1250
"2334",3759,0,128.33,128.33,"increase",128.33,51,0,51
"2335",4563,4550.24,2376.82,-2173.42,"increase",6927.06,3554,2446,1108
"2336",378,4709.53,5475.83,766.3,"increase",10185.36,4053,1949,2104
"2337",413,16.51,3.68,-12.83,"increase",20.19,16,14,2
"2338",549,21.56,27.22,5.66,"increase",48.78,25,8,17
"2339",818,4049.59,4898.44,848.85,"increase",8948.03,2808,1268,1540
"2340",1180,8124.04,9923.7,1799.66,"increase",18047.74,6179,2781,3398
"2341",1186,12633.59,13578.02,944.43,"increase",26211.61,16753,8767,7986
"2342",2116,4721.04,4877.78,156.74,"increase",9598.82,2917,1370,1547
"2343",2301,3157.63,3516.27,358.64,"increase",6673.9,2863,1387,1476
"2344",3054,4326.42,4743.2,416.78,"increase",9069.62,2614,1242,1372
"2345",3170,3727.87,5549.89,1822.02,"increase",9277.76,2962,1324,1638
"2346",3490,1850.94,2456.22,605.28,"increase",4307.16,1529,742,787
"2347",3795,3661.59,3350.67,-310.92,"increase",7012.26,3237,1661,1576
"2348",4133,2749.22,4800.73,2051.51,"increase",7549.95,2373,874,1499
"2349",4280,1570.77,1588.36,17.5900000000001,"increase",3159.13,1360,675,685
"2350",4686,3267.37,2700.45,-566.92,"increase",5967.82,2419,1355,1064
"2351",4810,1078.54,671.19,-407.35,"increase",1749.73,682,383,299
"2352",4891,79.23,251.41,172.18,"increase",330.64,124,24,100
"2353",41,1807.33,1849.56,42.23,"increase",3656.89,1755,858,897
"2354",1210,6504.76,2596.39,-3908.37,"increase",9101.15,2912,2140,772
"2355",1450,900.06,1425.46,525.4,"increase",2325.52,749,303,446
"2356",1451,900.06,1425.46,525.4,"increase",2325.52,749,303,446
"2357",2030,4494.49,5208.66,714.17,"increase",9703.15,3038,1508,1530
"2358",2047,82.15,85.04,2.89,"increase",167.19,54,28,26
"2359",2121,220.35,267.74,47.39,"increase",488.09,164,69,95
"2360",2398,10567.56,10456.67,-110.889999999999,"increase",21024.23,5125,2522,2603
"2361",2494,81.02,0,-81.02,"increase",81.02,31,31,0
"2362",2840,2799.63,2518.17,-281.46,"increase",5317.8,2113,1115,998
"2363",3209,0,101.12,101.12,"increase",101.12,27,0,27
"2364",3499,2856.95,2118.83,-738.12,"increase",4975.78,1817,1052,765
"2365",4348,16.36,0,-16.36,"increase",16.36,6,6,0
"2366",4555,2926.85,3528.42,601.57,"increase",6455.27,2827,1139,1688
"2367",4889,1651.65,835.65,-816,"increase",2487.3,1105,738,367
"2368",692,4360.13,2642.55,-1717.58,"increase",7002.68,3539,2082,1457
"2369",1102,3804.3,5511.88,1707.58,"increase",9316.18,2738,1158,1580
"2370",1351,2447.71,1354.88,-1092.83,"increase",3802.59,1689,1004,685
"2371",1652,12680.99,9621.98,-3059.01,"increase",22302.97,9299,5288,4011
"2372",1708,3468.19,3205.14,-263.05,"increase",6673.33,2292,1174,1118
"2373",1954,3367.28,2215.28,-1152,"increase",5582.56,1742,1108,634
"2374",2496,2731.82,1731.91,-999.91,"increase",4463.73,1224,691,533
"2375",2506,4352.42,4608.69,256.27,"increase",8961.11,2444,1267,1177
"2376",3371,25.44,0,-25.44,"increase",25.44,8,8,0
"2377",3464,1753.7,1951.82,198.12,"increase",3705.52,1364,631,733
"2378",4115,95.85,0,-95.85,"increase",95.85,30,30,0
"2379",4230,4987.67,5040.44,52.7699999999995,"increase",10028.11,4056,1780,2276
"2380",4399,2480.65,3063.08,582.43,"increase",5543.73,2162,954,1208
"2381",4486,3676.27,3919.16,242.89,"increase",7595.43,3196,1512,1684
"2382",4745,3385.09,3520.34,135.25,"increase",6905.43,2534,1250,1284
"2383",4779,3843.78,2931.07,-912.71,"increase",6774.85,2605,1466,1139
"2384",1741,4722.7,6443.09,1720.39,"increase",11165.79,4765,2121,2644
"2385",1853,92.98,88.89,-4.09,"increase",181.87,67,40,27
"2386",1865,4782.1,4646.77,-135.33,"increase",9428.87,3488,1730,1758
"2387",1950,1859.15,1896.69,37.54,"increase",3755.84,1375,695,680
"2388",1965,6449.82,5401.42,-1048.4,"increase",11851.24,3691,2110,1581
"2389",2019,6327.94,9306.81,2978.87,"increase",15634.75,4894,1871,3023
"2390",2556,9857.09,9487.54,-369.549999999999,"increase",19344.63,4807,2418,2389
"2391",4178,12.18,0,-12.18,"increase",12.18,2,2,0
"2392",4685,2155.75,6102.45,3946.7,"increase",8258.2,1569,484,1085
"2393",158,2244.14,3252.84,1008.7,"increase",5496.98,2234,956,1278
"2394",257,3498,4384.25,886.25,"increase",7882.25,2912,1328,1584
"2395",1554,4856.89,5845.83,988.94,"increase",10702.72,3883,1731,2152
"2396",1654,6205.97,5824.83,-381.14,"increase",12030.8,5395,2653,2742
"2397",2353,2522.14,2667.97,145.83,"increase",5190.11,1818,895,923
"2398",2362,1089.89,994.76,-95.1300000000001,"increase",2084.65,673,397,276
"2399",2941,3912.01,3052.76,-859.25,"increase",6964.77,2877,1641,1236
"2400",3430,4019.29,4729.28,709.99,"increase",8748.57,2990,1334,1656
"2401",3638,11477.27,7656.28,-3820.99,"increase",19133.55,5793,3516,2277
"2402",3810,11200.19,10324.36,-875.83,"increase",21524.55,8738,4416,4322
"2403",4520,2776.52,3875.72,1099.2,"increase",6652.24,3141,1329,1812
"2404",629,6506.18,5886.88,-619.3,"increase",12393.06,3741,2110,1631
"2405",1080,319.29,0,-319.29,"increase",319.29,80,80,0
"2406",1252,54.39,0,-54.39,"increase",54.39,18,18,0
"2407",2997,5544.66,5902.58,357.92,"increase",11447.24,4554,2273,2281
"2408",3218,37.3,47.46,10.16,"increase",84.76,19,7,12
"2409",4363,2.5,0,-2.5,"increase",2.5,2,2,0
"2410",4471,2415.37,2055.44,-359.93,"increase",4470.81,1426,710,716
"2411",4546,5856.69,2289.9,-3566.79,"increase",8146.59,2336,1701,635
"2412",4932,4032.48,4158.86,126.38,"increase",8191.34,3994,1994,2000
"2413",443,4237.39,6384.88,2147.49,"increase",10622.27,3583,1456,2127
"2414",466,14.98,21.53,6.55,"increase",36.51,9,2,7
"2415",777,2557.59,2374.44,-183.15,"increase",4932.03,1531,776,755
"2416",908,5213.22,4262.08,-951.14,"increase",9475.3,3518,1999,1519
"2417",1161,2737.04,3056.05,319.01,"increase",5793.09,2106,1053,1053
"2418",1218,0,88.61,88.61,"increase",88.61,18,0,18
"2419",1251,6748.22,7133.08,384.86,"increase",13881.3,5234,2488,2746
"2420",1392,5220.11,4615.3,-604.809999999999,"increase",9835.41,4271,2311,1960
"2421",1740,2498.9,2725.3,226.4,"increase",5224.2,2428,1141,1287
"2422",1916,7564.64,8655.13,1090.49,"increase",16219.77,7891,3906,3985
"2423",2052,19.17,0,-19.17,"increase",19.17,3,3,0
"2424",2264,3163.55,3074.94,-88.6100000000001,"increase",6238.49,2272,1133,1139
"2425",2508,4012.44,3566.17,-446.27,"increase",7578.61,2985,1587,1398
"2426",2552,2520.27,4624.06,2103.79,"increase",7144.33,2311,967,1344
"2427",2705,2740.54,3382.8,642.26,"increase",6123.34,3114,1434,1680
"2428",2726,3900.34,4505.8,605.46,"increase",8406.14,3891,1779,2112
"2429",2800,2978.9,3427.38,448.48,"increase",6406.28,2389,1102,1287
"2430",3060,6097.71,5029.86,-1067.85,"increase",11127.57,4071,2087,1984
"2431",3153,2978.16,2220.13,-758.03,"increase",5198.29,2623,1547,1076
"2432",3350,3763.63,2202.27,-1561.36,"increase",5965.9,2574,1568,1006
"2433",3526,1952.21,1702.1,-250.11,"increase",3654.31,1245,621,624
"2434",3706,5476.3,5818.45,342.15,"increase",11294.75,5042,2611,2431
"2435",3970,6504.41,6633.48,129.070000000001,"increase",13137.89,4845,2467,2378
"2436",4017,11.48,0,-11.48,"increase",11.48,2,2,0
"2437",4285,4707.84,5550.45,842.61,"increase",10258.29,5406,2680,2726
"2438",4321,3023.63,2570.87,-452.76,"increase",5594.5,1814,939,875
"2439",4374,6527.12,6818.64,291.52,"increase",13345.76,5762,2846,2916
"2440",4391,10.74,0,-10.74,"increase",10.74,7,7,0
"2441",4613,2119.61,1894.55,-225.06,"increase",4014.16,1703,850,853
"2442",4614,4882.05,4704.37,-177.68,"increase",9586.42,3501,1853,1648
"2443",4791,0,35.87,35.87,"increase",35.87,7,0,7
"2444",327,18178.52,10182.06,-7996.46,"increase",28360.58,11594,7417,4177
"2445",478,118.09,106.6,-11.49,"increase",224.69,58,28,30
"2446",499,7180.66,3545.71,-3634.95,"increase",10726.37,2686,1793,893
"2447",1346,9177.27,5542.97,-3634.3,"increase",14720.24,6840,4314,2526
"2448",1588,4241.53,2431.57,-1809.96,"increase",6673.1,2154,1425,729
"2449",1629,0,4.41,4.41,"increase",4.41,2,0,2
"2450",1660,4251.66,3989.29,-262.37,"increase",8240.95,2988,1674,1314
"2451",1695,5913.44,4474.41,-1439.03,"increase",10387.85,3833,2209,1624
"2452",1761,2202.82,3181.48,978.66,"increase",5384.3,1996,799,1197
"2453",1829,0,49.09,49.09,"increase",49.09,21,0,21
"2454",1987,0,16.01,16.01,"increase",16.01,6,0,6
"2455",2160,3074.38,3553.02,478.64,"increase",6627.4,2809,1329,1480
"2456",2370,3056.09,3348.1,292.01,"increase",6404.19,3074,1550,1524
"2457",2487,4082.07,4748.78,666.71,"increase",8830.85,4485,1993,2492
"2458",2504,5606.03,5963.99,357.96,"increase",11570.02,3812,1955,1857
"2459",2687,2547.48,3785.88,1238.4,"increase",6333.36,2457,1186,1271
"2460",2804,3523.46,4586.14,1062.68,"increase",8109.6,3323,1575,1748
"2461",2868,4771.82,4476.17,-295.65,"increase",9247.99,2946,1475,1471
"2462",3047,3289.3,3341.9,52.5999999999999,"increase",6631.2,3769,1834,1935
"2463",3241,3527.15,3898.81,371.66,"increase",7425.96,2654,1227,1427
"2464",3561,4801.73,3808.88,-992.85,"increase",8610.61,3288,1986,1302
"2465",4169,2022.73,2003.12,-19.6099999999999,"increase",4025.85,1110,503,607
"2466",4270,11373.24,11892.11,518.870000000001,"increase",23265.35,7969,3636,4333
"2467",4272,4769.27,6360.89,1591.62,"increase",11130.16,3717,1610,2107
"2468",4322,0,166.99,166.99,"increase",166.99,29,0,29
"2469",4349,5721.34,4989.44,-731.9,"increase",10710.78,4608,2658,1950
"2470",4397,5343.28,5901.54,558.26,"increase",11244.82,4577,2042,2535
"2471",4454,10508.92,11359.5,850.58,"increase",21868.42,7757,4008,3749
"2472",4587,5085.46,4660.42,-425.04,"increase",9745.88,3639,1883,1756
"2473",4692,2680.27,2441.24,-239.03,"increase",5121.51,1862,1008,854
"2474",4703,14376.88,14281.12,-95.7600000000002,"increase",28658,6940,3382,3558
"2475",4872,2999.6,4646.85,1647.25,"increase",7646.45,2546,977,1569
"2476",1024,2253.16,2808.29,555.13,"increase",5061.45,1931,795,1136
"2477",1060,3957.92,2985.39,-972.53,"increase",6943.31,2829,1650,1179
"2478",1426,3099.79,2795.4,-304.39,"increase",5895.19,1631,837,794
"2479",1536,6989.66,4914.17,-2075.49,"increase",11903.83,3576,2130,1446
"2480",1711,10.98,0,-10.98,"increase",10.98,2,2,0
"2481",1737,2058.22,2297.17,238.95,"increase",4355.39,1395,669,726
"2482",1886,9181.24,8980.57,-200.67,"increase",18161.81,5550,2756,2794
"2483",2050,4236.02,5320.49,1084.47,"increase",9556.51,3854,1637,2217
"2484",2179,390.04,1402.98,1012.94,"increase",1793.02,814,179,635
"2485",2933,8531.95,13423.31,4891.36,"increase",21955.26,9082,3584,5498
"2486",3138,178.15,0,-178.15,"increase",178.15,79,79,0
"2487",3175,3678.71,4200.91,522.2,"increase",7879.62,2621,1278,1343
"2488",3279,16790.86,13224.04,-3566.82,"increase",30014.9,8866,5118,3748
"2489",4379,60.32,0,-60.32,"increase",60.32,11,11,0
"2490",4539,7622.33,4249.01,-3373.32,"increase",11871.34,3473,2298,1175
"2491",146,10779.14,11010.55,231.41,"increase",21789.69,5451,2840,2611
"2492",237,533.09,112.32,-420.77,"increase",645.41,257,209,48
"2493",1635,6964.47,8119.46,1154.99,"increase",15083.93,4150,2036,2114
"2494",1730,3165.74,4934.4,1768.66,"increase",8100.14,2798,1124,1674
"2495",1780,5836.89,6980.69,1143.8,"increase",12817.58,4325,1994,2331
"2496",1824,12201.56,12231.31,29.75,"increase",24432.87,5103,2468,2635
"2497",1859,9314.95,8942.44,-372.51,"increase",18257.39,5792,3033,2759
"2498",2044,1.69,107.62,105.93,"increase",109.31,47,1,46
"2499",2543,0,130.71,130.71,"increase",130.71,44,0,44
"2500",2914,2184.53,3211.31,1026.78,"increase",5395.84,2347,943,1404
"2501",3061,3989.58,7193.85,3204.27,"increase",11183.43,4731,1709,3022
"2502",3527,13518.9,13491.45,-27.4499999999989,"increase",27010.35,8934,4611,4323
"2503",3854,2500.44,2800.81,300.37,"increase",5301.25,1644,762,882
"2504",4269,32.95,0,-32.95,"increase",32.95,18,18,0
"2505",4377,1530.67,1302.98,-227.69,"increase",2833.65,1536,794,742
"2506",4787,562.25,88.23,-474.02,"increase",650.48,226,197,29
"2507",721,3595.34,2572.35,-1022.99,"increase",6167.69,2617,1499,1118
"2508",758,2464.11,2002.41,-461.7,"increase",4466.52,1806,988,818
"2509",759,3339.95,2259.5,-1080.45,"increase",5599.45,2041,1170,871
"2510",798,1428.96,1902.75,473.79,"increase",3331.71,1504,635,869
"2511",819,1.25,75.17,73.92,"increase",76.42,31,1,30
"2512",1460,23.46,0,-23.46,"increase",23.46,6,6,0
"2513",1483,65.76,231.75,165.99,"increase",297.51,80,21,59
"2514",1532,0,46.81,46.81,"increase",46.81,15,0,15
"2515",1834,2443.7,2284.15,-159.55,"increase",4727.85,1471,768,703
"2516",1975,3904.17,3593.03,-311.14,"increase",7497.2,4173,2129,2044
"2517",2154,5177.01,3841.41,-1335.6,"increase",9018.42,3801,2135,1666
"2518",2659,2991.32,3962.93,971.61,"increase",6954.25,2978,1320,1658
"2519",3310,1995.78,2627.97,632.19,"increase",4623.75,2291,926,1365
"2520",4130,4.99,0,-4.99,"increase",4.99,1,1,0
"2521",218,0,149.15,149.15,"increase",149.15,53,0,53
"2522",1390,2776.99,3301.45,524.46,"increase",6078.44,2367,1148,1219
"2523",2054,346.58,0,-346.58,"increase",346.58,87,87,0
"2524",2214,1380.07,2002.55,622.48,"increase",3382.62,1104,420,684
"2525",2757,5856.87,7153.22,1296.35,"increase",13010.09,4152,1848,2304
"2526",28,6215.99,6452.92,236.93,"increase",12668.91,5096,2396,2700
"2527",42,5027.19,5921.25,894.06,"increase",10948.44,4410,1795,2615
"2528",351,6533.59,6591.85,58.2600000000002,"increase",13125.44,3726,1892,1834
"2529",509,1908.02,2843.22,935.2,"increase",4751.24,2048,827,1221
"2530",553,7618.77,6402.67,-1216.1,"increase",14021.44,6631,3636,2995
"2531",750,3987.64,3700.03,-287.61,"increase",7687.67,2340,1146,1194
"2532",1530,34.19,0,-34.19,"increase",34.19,18,18,0
"2533",2786,3889.17,3685.77,-203.4,"increase",7574.94,2304,1222,1082
"2534",3204,4657.28,2811.04,-1846.24,"increase",7468.32,2689,1682,1007
"2535",3522,7593.67,5604.5,-1989.17,"increase",13198.17,4718,2720,1998
"2536",3678,2507.2,2634.66,127.46,"increase",5141.86,1913,956,957
"2537",3750,813.53,947.68,134.15,"increase",1761.21,822,399,423
"2538",558,8716.18,9125.08,408.9,"increase",17841.26,6927,3351,3576
"2539",1567,3593.09,2261.73,-1331.36,"increase",5854.82,1914,1185,729
"2540",1657,2801.91,2381,-420.91,"increase",5182.91,1608,876,732
"2541",2139,3995.92,3819.4,-176.52,"increase",7815.32,2926,1523,1403
"2542",2205,16545.75,7094.92,-9450.83,"increase",23640.67,9934,7100,2834
"2543",2313,3026.85,1694.94,-1331.91,"increase",4721.79,2876,1900,976
"2544",2486,5112.4,5214.28,101.88,"increase",10326.68,2341,1119,1222
"2545",2542,4830.71,4774.35,-56.3599999999997,"increase",9605.06,4844,2477,2367
"2546",3857,4753.67,4607.88,-145.79,"increase",9361.55,3505,1759,1746
"2547",4095,31.45,0,-31.45,"increase",31.45,7,7,0
"2548",4145,7039.38,7533.53,494.15,"increase",14572.91,5592,2780,2812
"2549",4509,3303.85,4255.32,951.47,"increase",7559.17,2459,1067,1392
"2550",4622,2925.18,2899.14,-26.04,"increase",5824.32,2042,1004,1038
"2551",4887,4599.15,5378.79,779.64,"increase",9977.94,3523,1576,1947
"2552",4928,1807.1,2390.32,583.22,"increase",4197.42,1284,517,767
"2553",4929,3471.75,5322.2,1850.45,"increase",8793.95,3521,1413,2108
"2554",334,5213.06,1943.92,-3269.14,"increase",7156.98,2175,1530,645
"2555",1482,1989.2,2364.03,374.83,"increase",4353.23,1605,735,870
"2556",2081,2534.04,2719.73,185.69,"increase",5253.77,1531,763,768
"2557",2150,1726.34,3520.83,1794.49,"increase",5247.17,2014,651,1363
"2558",2452,315.55,0,-315.55,"increase",315.55,83,83,0
"2559",2707,1763.2,2702.09,938.89,"increase",4465.29,2084,773,1311
"2560",2781,28780.94,26092.81,-2688.13,"increase",54873.75,8614,4562,4052
"2561",3360,0,85.19,85.19,"increase",85.19,24,0,24
"2562",4167,0,4023.51,4023.51,"increase",4023.51,1546,0,1546
"2563",4422,95.13,0,-95.13,"increase",95.13,33,33,0
"2564",4873,8374.42,5994.69,-2379.73,"increase",14369.11,5812,3262,2550
"2565",6,13013.14,9719.33,-3293.81,"increase",22732.47,6008,3311,2697
"2566",1373,2071.33,2906.16,834.83,"increase",4977.49,1668,709,959
"2567",1779,9131.33,9372.92,241.59,"increase",18504.25,5892,2831,3061
"2568",2161,1727.27,1276.12,-451.15,"increase",3003.39,1393,825,568
"2569",2269,1890.32,1509.95,-380.37,"increase",3400.27,2451,1416,1035
"2570",3041,0,64.77,64.77,"increase",64.77,18,0,18
"2571",3564,2294.35,1414.05,-880.3,"increase",3708.4,1259,735,524
"2572",3661,3258,2779.3,-478.7,"increase",6037.3,1985,1074,911
"2573",3712,7547.29,8502.2,954.910000000001,"increase",16049.49,5506,2464,3042
"2574",4310,1505.92,2624.67,1118.75,"increase",4130.59,1760,705,1055
"2575",4578,6350.71,6303.3,-47.4099999999999,"increase",12654.01,3297,1700,1597
"2576",563,0,9,9,"increase",9,2,0,2
"2577",651,3691.61,4801.65,1110.04,"increase",8493.26,2841,1259,1582
"2578",756,4229.96,4533.08,303.12,"increase",8763.04,3444,1711,1733
"2579",1463,10820.42,12204.59,1384.17,"increase",23025.01,7762,3538,4224
"2580",1989,5625.78,4117.42,-1508.36,"increase",9743.2,4741,2693,2048
"2581",2905,3356.78,3311.44,-45.3400000000001,"increase",6668.22,2452,1312,1140
"2582",3986,2417.14,1995.7,-421.44,"increase",4412.84,2195,1155,1040
"2583",4013,0,141.84,141.84,"increase",141.84,41,0,41
"2584",4334,0,8.29,8.29,"increase",8.29,3,0,3
"2585",75,0,91.23,91.23,"increase",91.23,24,0,24
"2586",693,2582.62,2994.08,411.46,"increase",5576.7,2256,976,1280
"2587",1391,241.14,199.58,-41.56,"increase",440.72,124,67,57
"2588",2089,2293.31,3211.22,917.91,"increase",5504.53,2018,821,1197
"2589",2148,2246.6,2556.78,310.18,"increase",4803.38,2128,913,1215
"2590",4001,950.3,936.9,-13.4000000000001,"increase",1887.2,860,439,421
"2591",4252,3187.14,3221.69,34.5500000000002,"increase",6408.83,3241,1456,1785
"2592",1656,9617.55,8853.57,-763.98,"increase",18471.12,4457,2348,2109
"2593",2270,10051.8,10559.98,508.18,"increase",20611.78,6583,3174,3409
"2594",2394,0,19.47,19.47,"increase",19.47,4,0,4
"2595",3147,0,25.4,25.4,"increase",25.4,8,0,8
"2596",3543,3263.83,5826.6,2562.77,"increase",9090.43,2981,1132,1849
"2597",4314,3209.67,4084.12,874.45,"increase",7293.79,1541,678,863
"2598",4858,6069.3,5562.5,-506.8,"increase",11631.8,4685,2413,2272
"2599",4295,3814.61,3193.7,-620.91,"increase",7008.31,2253,1229,1024
"2600",2511,0,2,2,"increase",2,2,0,2
"2601",2546,3426.93,3087.92,-339.01,"increase",6514.85,2778,1358,1420
"2602",4242,2989.25,3172.98,183.73,"increase",6162.23,1793,808,985
"2603",57,2497.26,2492.68,-4.57999999999993,"increase",4989.94,1525,773,752
"2604",300,2538.82,2972.91,434.09,"increase",5511.73,1801,822,979
"2605",537,1523.45,294.1,-1229.35,"increase",1817.55,523,445,78
"2606",566,2171.04,2178.31,7.26999999999998,"increase",4349.35,2003,1049,954
"2607",890,1749.62,2763.92,1014.3,"increase",4513.54,2365,1007,1358
"2608",891,5206.51,4733.22,-473.29,"increase",9939.73,2325,1206,1119
"2609",1095,2256.14,3170.42,914.28,"increase",5426.56,1806,740,1066
"2610",1241,2525.24,3642.72,1117.48,"increase",6167.96,2589,1158,1431
"2611",1611,2207.8,2133.34,-74.46,"increase",4341.14,1405,689,716
"2612",1869,5866.24,6510.05,643.81,"increase",12376.29,3461,1592,1869
"2613",2087,3127.59,3558.1,430.51,"increase",6685.69,2279,1063,1216
"2614",2173,2698.27,1794.04,-904.23,"increase",4492.31,1620,934,686
"2615",2650,3835.52,3301.6,-533.92,"increase",7137.12,2735,1398,1337
"2616",2691,2428.39,3265.22,836.83,"increase",5693.61,3362,1505,1857
"2617",2778,1560.12,1472.44,-87.6800000000001,"increase",3032.56,1328,678,650
"2618",2886,2540.43,2276.55,-263.88,"increase",4816.98,2233,1162,1071
"2619",3339,4151.13,3729.42,-421.71,"increase",7880.55,3121,1614,1507
"2620",3418,1290.42,1261.62,-28.8,"increase",2552.04,973,484,489
"2621",3658,2717.75,2751.48,33.73,"increase",5469.23,2692,1333,1359
"2622",3903,1069.74,2776.45,1706.71,"increase",3846.19,1364,379,985
"2623",4271,8276.88,7026.33,-1250.55,"increase",15303.21,5161,2743,2418
"2624",4603,2723.68,2623.42,-100.26,"increase",5347.1,2449,1191,1258
"2625",4960,5057.82,10315.36,5257.54,"increase",15373.18,5094,1635,3459
"2626",339,11.66,0,-11.66,"increase",11.66,5,5,0
"2627",2948,9248.16,8657.1,-591.059999999999,"increase",17905.26,3233,1680,1553
"2628",448,18,0,-18,"increase",18,3,3,0
"2629",632,2627.79,3054.21,426.42,"increase",5682,1811,1003,808
"2630",689,18677.72,22897.67,4219.95,"increase",41575.39,15852,6806,9046
"2631",1047,7247.19,8205.55,958.359999999999,"increase",15452.74,4567,2037,2530
"2632",1174,4094.08,5579.14,1485.06,"increase",9673.22,3837,1561,2276
"2633",1308,5181.14,3466.09,-1715.05,"increase",8647.23,3627,2176,1451
"2634",1535,4346.37,4250.76,-95.6099999999997,"increase",8597.13,2551,1293,1258
"2635",1617,0,4343.21,4343.21,"increase",4343.21,1188,0,1188
"2636",1771,4351.09,3191.14,-1159.95,"increase",7542.23,2602,1380,1222
"2637",2124,8253.6,7705.93,-547.67,"increase",15959.53,7846,4177,3669
"2638",2130,1364.04,957.29,-406.75,"increase",2321.33,925,479,446
"2639",2265,5430.48,5433.76,3.27999999999975,"increase",10864.24,3537,1834,1703
"2640",2285,2056.29,2270.78,214.49,"increase",4327.07,1768,853,915
"2641",2360,5426.11,4068.83,-1357.28,"increase",9494.94,3386,2103,1283
"2642",2616,6899.75,7490.31,590.56,"increase",14390.06,5320,2696,2624
"2643",2851,3217.49,4170.15,952.659999999999,"increase",7387.64,2375,1093,1282
"2644",3832,4361.98,6382.71,2020.73,"increase",10744.69,3169,1310,1859
"2645",3908,2461.46,3980.7,1519.24,"increase",6442.16,2126,822,1304
"2646",3956,26.24,1.99,-24.25,"increase",28.23,13,12,1
"2647",4439,97.84,366.69,268.85,"increase",464.53,154,40,114
"2648",1008,4868.92,5428.77,559.85,"increase",10297.69,3434,1508,1926
"2649",1639,8515.35,6992.7,-1522.65,"increase",15508.05,4627,2578,2049
"2650",1754,4517.14,7803.69,3286.55,"increase",12320.83,3893,1396,2497
"2651",1938,4816.75,2704.2,-2112.55,"increase",7520.95,2239,1385,854
"2652",2332,9413.86,7671.87,-1741.99,"increase",17085.73,5086,2679,2407
"2653",2475,2031.23,2466.1,434.87,"increase",4497.33,1351,600,751
"2654",2829,5200.54,4045.47,-1155.07,"increase",9246.01,4030,2324,1706
"2655",2929,3682.55,4203.94,521.389999999999,"increase",7886.49,3427,1563,1864
"2656",3329,2996.87,3444.86,447.99,"increase",6441.73,1689,807,882
"2657",4156,604.49,1270.38,665.89,"increase",1874.87,608,188,420
"2658",4647,9413.86,8435.09,-978.77,"increase",17848.95,5417,2815,2602
"2659",4724,3780.18,4043.01,262.83,"increase",7823.19,2128,1102,1026
"2660",109,9467.99,9581.25,113.26,"increase",19049.24,5203,2612,2591
"2661",1055,843.37,0,-843.37,"increase",843.37,271,271,0
"2662",1898,966.65,1140.54,173.89,"increase",2107.19,1163,547,616
"2663",1982,0,6.99,6.99,"increase",6.99,1,0,1
"2664",2263,3089.73,3620.35,530.62,"increase",6710.08,2155,1089,1066
"2665",2866,53.89,517.71,463.82,"increase",571.6,164,13,151
"2666",4769,4562.81,4688.52,125.71,"increase",9251.33,3900,2077,1823
"2667",4807,4859.33,4564.67,-294.66,"increase",9424,3812,1942,1870
"2668",4856,2273.65,3387.7,1114.05,"increase",5661.35,2455,954,1501
"2669",1861,3437.81,3846.05,408.24,"increase",7283.86,1769,878,891
"2670",2292,5406.8,4484.49,-922.31,"increase",9891.29,4237,2179,2058
"2671",2340,6834.23,7834.77,1000.54,"increase",14669,5243,2573,2670
"2672",96,4359.43,2992.35,-1367.08,"increase",7351.78,2351,1401,950
"2673",2006,8969,9446.31,477.309999999999,"increase",18415.31,8146,4039,4107
"2674",2247,12.77,0,-12.77,"increase",12.77,4,4,0
"2675",2598,4987.53,6803.98,1816.45,"increase",11791.51,5344,2336,3008
"2676",3704,2256.09,4277.34,2021.25,"increase",6533.43,2181,734,1447
"2677",4481,5640.95,6360.74,719.79,"increase",12001.69,5090,2236,2854
"2678",4655,882.79,1290.53,407.74,"increase",2173.32,992,284,708
"2679",4915,1459.55,588.36,-871.19,"increase",2047.91,1415,1014,401
"2680",885,1702.68,1951.9,249.22,"increase",3654.58,1139,561,578
"2681",927,3327.78,3778.04,450.26,"increase",7105.82,3533,1619,1914
"2682",1908,2683.67,3197.91,514.24,"increase",5881.58,3236,1291,1945
"2683",277,0,15.99,15.99,"increase",15.99,3,0,3
"2684",1927,27.88,0,-27.88,"increase",27.88,12,12,0
"2685",2425,3144.82,3521.56,376.74,"increase",6666.38,2224,1088,1136
"2686",2903,4.99,0,-4.99,"increase",4.99,1,1,0
"2687",92,2438.49,2640.64,202.15,"increase",5079.13,1986,1009,977
"2688",179,4320.9,4953.07,632.17,"increase",9273.97,4018,1847,2171
"2689",480,3215.36,4886.14,1670.78,"increase",8101.5,3123,1373,1750
"2690",571,3517.32,4105.37,588.05,"increase",7622.69,2228,1064,1164
"2691",746,2331.46,1951.11,-380.35,"increase",4282.57,2351,1286,1065
"2692",1293,2780.97,3279.53,498.56,"increase",6060.5,2274,1053,1221
"2693",1294,1161.55,796.3,-365.25,"increase",1957.85,894,545,349
"2694",1574,4514.59,4592.22,77.6300000000001,"increase",9106.81,3894,2006,1888
"2695",1577,1728.47,2094.43,365.96,"increase",3822.9,1745,827,918
"2696",1812,15.44,0,-15.44,"increase",15.44,6,6,0
"2697",2228,5197.54,4564.73,-632.809999999999,"increase",9762.27,2800,1563,1237
"2698",2704,6329.37,10181.97,3852.6,"increase",16511.34,6419,2384,4035
"2699",3066,24.06,0,-24.06,"increase",24.06,8,8,0
"2700",3541,2098.4,2072.7,-25.7000000000003,"increase",4171.1,1641,832,809
"2701",4710,8161.84,8926.22,764.379999999999,"increase",17088.06,8506,4294,4212
"2702",4733,9406.52,5697.65,-3708.87,"increase",15104.17,6593,4034,2559
"2703",4895,2234.86,6141.31,3906.45,"increase",8376.17,3204,1030,2174
"2704",4950,3852.37,6009.4,2157.03,"increase",9861.77,4240,1516,2724
"2705",4286,11.29,0,-11.29,"increase",11.29,1,1,0
"2706",978,4938.61,1662.16,-3276.45,"increase",6600.77,2195,1637,558
"2707",32,3405.67,3831.04,425.37,"increase",7236.71,2855,1352,1503
"2708",1044,11021.45,11882.32,860.869999999999,"increase",22903.77,7110,3360,3750
"2709",1596,6518.79,5561.19,-957.599999999999,"increase",12079.98,3395,1896,1499
"2710",483,2209.76,2317.26,107.5,"increase",4527.02,1917,878,1039
"2711",913,5384.19,4537.96,-846.23,"increase",9922.15,3617,1875,1742
"2712",922,2009.74,1237.99,-771.75,"increase",3247.73,798,491,307
"2713",1307,2217.33,2785.94,568.61,"increase",5003.27,2190,1086,1104
"2714",1457,11718.12,8233.5,-3484.62,"increase",19951.62,7143,4078,3065
"2715",1475,1647.83,1265.3,-382.53,"increase",2913.13,907,477,430
"2716",1958,3439.41,2978.12,-461.29,"increase",6417.53,3207,1756,1451
"2717",1999,0,57.82,57.82,"increase",57.82,10,0,10
"2718",2210,11642.16,12911.09,1268.93,"increase",24553.25,8429,4020,4409
"2719",2266,0,296.17,296.17,"increase",296.17,109,0,109
"2720",2283,3045.06,2962.67,-82.3899999999999,"increase",6007.73,2227,1149,1078
"2721",3308,3232.96,2910.8,-322.16,"increase",6143.76,2789,1529,1260
"2722",4325,4733.23,5066.48,333.25,"increase",9799.71,3331,1626,1705
"2723",1516,2864.82,2212.41,-652.41,"increase",5077.23,2291,1284,1007
"2724",1973,0,36.9,36.9,"increase",36.9,21,0,21
"2725",1993,462.38,0,-462.38,"increase",462.38,188,188,0
"2726",2033,4595.87,4119.2,-476.67,"increase",8715.07,3830,2007,1823
"2727",2046,2.18,164.86,162.68,"increase",167.04,33,2,31
"2728",2055,2225.02,4774.8,2549.78,"increase",6999.82,2723,772,1951
"2729",2118,6158.16,6328.82,170.66,"increase",12486.98,4720,2314,2406
"2730",2238,3816.87,4245.24,428.37,"increase",8062.11,3517,1629,1888
"2731",3729,4929.69,4323.83,-605.860000000001,"increase",9253.52,3685,1940,1745
"2732",4044,0,11.57,11.57,"increase",11.57,4,0,4
"2733",4046,245.66,31.65,-214.01,"increase",277.31,51,46,5
"2734",4048,1905.86,1844.94,-60.9199999999998,"increase",3750.8,1615,887,728
"2735",4199,3017.31,2912.48,-104.83,"increase",5929.79,1889,983,906
"2736",4384,3989.1,4965.37,976.27,"increase",8954.47,3066,1421,1645
"2737",4424,0,88.16,88.16,"increase",88.16,22,0,22
"2738",4487,6226.8,4908.3,-1318.5,"increase",11135.1,3211,1812,1399
"2739",4523,5840.46,7453.81,1613.35,"increase",13294.27,5223,2128,3095
"2740",4538,3577.99,3643.23,65.2399999999998,"increase",7221.22,3109,1593,1516
"2741",4570,0,617.38,617.38,"increase",617.38,289,0,289
"2742",1221,7661.34,8623.78,962.440000000001,"increase",16285.12,5984,2878,3106
"2743",1731,4035.79,3913.42,-122.37,"increase",7949.21,2496,1272,1224
"2744",1787,3718.27,3391.68,-326.59,"increase",7109.95,2871,1472,1399
"2745",1809,5574.57,7029,1454.43,"increase",12603.57,5920,2532,3388
"2746",2117,3409.97,3380.87,-29.1000000000004,"increase",6790.84,2794,1403,1391
"2747",3125,11759.26,10179.49,-1579.77,"increase",21938.75,8677,4846,3831
"2748",3878,2856.43,2886.5,30.0700000000002,"increase",5742.93,1775,827,948
"2749",4204,8492.01,8803.16,311.15,"increase",17295.17,6998,3592,3406
"2750",4596,2959.09,1938.31,-1020.78,"increase",4897.4,1028,590,438
"2751",737,3225.39,3620.83,395.44,"increase",6846.22,2655,1283,1372
"2752",1732,2799.37,1494.42,-1304.95,"increase",4293.79,1459,851,608
"2753",2796,3960.64,4265.92,305.28,"increase",8226.56,2987,1427,1560
"2754",3182,18.16,0,-18.16,"increase",18.16,5,5,0
"2755",4407,4819.32,4338.56,-480.759999999999,"increase",9157.88,3116,1649,1467
"2756",474,1.99,12.02,10.03,"increase",14.01,13,1,12
"2757",504,1491.32,1867.6,376.28,"increase",3358.92,2000,609,1391
"2758",1550,0,62.88,62.88,"increase",62.88,14,0,14
"2759",1984,3569.03,4460.64,891.61,"increase",8029.67,3650,1589,2061
"2760",2723,3417.01,2681.55,-735.46,"increase",6098.56,3396,1689,1707
"2761",4139,0,31.71,31.71,"increase",31.71,10,0,10
"2762",677,6709.85,6477.25,-232.6,"increase",13187.1,3999,1860,2139
"2763",2601,147.4,0,-147.4,"increase",147.4,57,57,0
"2764",132,0,18.3,18.3,"increase",18.3,6,0,6
"2765",506,5431.11,4922.81,-508.299999999999,"increase",10353.92,3909,2170,1739
"2766",717,2620.43,2381.93,-238.5,"increase",5002.36,2048,966,1082
"2767",805,9080.72,8759.52,-321.199999999999,"increase",17840.24,5962,3065,2897
"2768",982,1678.17,2363.34,685.17,"increase",4041.51,2001,857,1144
"2769",1160,1.39,0,-1.39,"increase",1.39,1,1,0
"2770",2057,6170.59,6746.36,575.77,"increase",12916.95,5991,3069,2922
"2771",2094,3954.95,2850.85,-1104.1,"increase",6805.8,2256,1285,971
"2772",2942,3104.96,3230.29,125.33,"increase",6335.25,3286,1612,1674
"2773",2953,2731.5,3549.04,817.54,"increase",6280.54,3323,1335,1988
"2774",2972,3686.38,4371.18,684.8,"increase",8057.56,3055,1430,1625
"2775",3181,12.34,219.65,207.31,"increase",231.99,80,6,74
"2776",3648,3653.27,3022.9,-630.37,"increase",6676.17,2474,1260,1214
"2777",3771,4450.44,4934.05,483.61,"increase",9384.49,2963,1487,1476
"2778",3834,1500.54,2725.02,1224.48,"increase",4225.56,2246,801,1445
"2779",3836,4956.3,5564.36,608.059999999999,"increase",10520.66,4042,1952,2090
"2780",3967,8329.21,6966.02,-1363.19,"increase",15295.23,4831,2767,2064
"2781",4350,2683.34,1985.39,-697.95,"increase",4668.73,1946,1022,924
"2782",4526,787.76,1044.01,256.25,"increase",1831.77,616,293,323
"2783",4638,3316.52,1899.55,-1416.97,"increase",5216.07,1947,1198,749
"2784",143,4307.73,4714.52,406.79,"increase",9022.25,4206,1957,2249
"2785",1154,6515.16,7358.49,843.33,"increase",13873.65,5263,2657,2606
"2786",1223,2645.56,4525.27,1879.71,"increase",7170.83,3268,1143,2125
"2787",1641,405.68,0,-405.68,"increase",405.68,148,148,0
"2788",1664,65.15,0,-65.15,"increase",65.15,18,18,0
"2789",1928,5779.84,8074.85,2295.01,"increase",13854.69,4580,1944,2636
"2790",2014,1.69,0,-1.69,"increase",1.69,1,1,0
"2791",2075,83.16,0,-83.16,"increase",83.16,47,47,0
"2792",2092,6906.71,7849.35,942.64,"increase",14756.06,8107,3890,4217
"2793",2093,2566.36,2569.46,3.09999999999991,"increase",5135.82,2166,1060,1106
"2794",2373,6750.86,6244.32,-506.54,"increase",12995.18,4664,2272,2392
"2795",2389,5441.2,5600.87,159.67,"increase",11042.07,3769,1826,1943
"2796",2480,23.98,0,-23.98,"increase",23.98,2,2,0
"2797",2658,2580.72,3157.08,576.36,"increase",5737.8,2421,1098,1323
"2798",2971,5869.67,5040.74,-828.93,"increase",10910.41,3594,1923,1671
"2799",4191,6210.41,5725.33,-485.08,"increase",11935.74,3460,1735,1725
"2800",4238,6544.14,5874.2,-669.940000000001,"increase",12418.34,4464,2339,2125
"2801",4313,2308.07,2879.79,571.72,"increase",5187.86,2689,1514,1175
"2802",4846,4871.95,7239.94,2367.99,"increase",12111.89,4559,1899,2660
"2803",74,264.67,126.24,-138.43,"increase",390.91,119,75,44
"2804",1640,22.98,33.37,10.39,"increase",56.35,9,6,3
"2805",1645,18.97,23.14,4.17,"increase",42.11,20,7,13
"2806",2287,2543.64,2378.53,-165.11,"increase",4922.17,1503,791,712
"2807",2908,4479.46,5360.81,881.35,"increase",9840.27,4080,1745,2335
"2808",3040,4701.27,2793.95,-1907.32,"increase",7495.22,2563,1576,987
"2809",4197,2807.79,3535.51,727.72,"increase",6343.3,2142,921,1221
"2810",232,16.03,0,-16.03,"increase",16.03,7,7,0
"2811",447,0,4,4,"increase",4,3,0,3
"2812",1131,0,20.45,20.45,"increase",20.45,10,0,10
"2813",1465,0,126.78,126.78,"increase",126.78,34,0,34
"2814",2204,4073.2,3308.37,-764.83,"increase",7381.57,2560,1459,1101
"2815",2329,8445.64,12736.96,4291.32,"increase",21182.6,10105,4019,6086
"2816",4880,6000.87,5737.34,-263.53,"increase",11738.21,3433,1836,1597
"2817",4881,5925.36,5123.65,-801.71,"increase",11049.01,4404,2308,2096
"2818",142,2788.28,5437.29,2649.01,"increase",8225.57,2963,1047,1916
"2819",855,4299.23,6196.33,1897.1,"increase",10495.56,4033,1700,2333
"2820",1013,8524.18,8500.63,-23.5499999999993,"increase",17024.81,9559,4992,4567
"2821",1148,5383.21,5136.15,-247.06,"increase",10519.36,4870,2526,2344
"2822",1765,10395.05,11297.96,902.910000000002,"increase",21693.01,6820,3336,3484
"2823",1773,3107.07,3022.73,-84.3400000000001,"increase",6129.8,2862,1407,1455
"2824",2692,4698.51,4907.94,209.43,"increase",9606.45,2753,1367,1386
"2825",1101,0,14.06,14.06,"increase",14.06,6,0,6
"2826",1501,72.72,0,-72.72,"increase",72.72,20,20,0
"2827",3152,6297.03,6509.6,212.570000000001,"increase",12806.63,2632,1304,1328
"2828",3713,1927.72,3501.52,1573.8,"increase",5429.24,2389,924,1465
"2829",88,0,3,3,"increase",3,3,0,3
"2830",437,7.76,0,-7.76,"increase",7.76,9,9,0
"2831",701,4030.92,2377.83,-1653.09,"increase",6408.75,2047,1322,725
"2832",873,3568.77,4909.64,1340.87,"increase",8478.41,2300,980,1320
"2833",1062,17.13,0,-17.13,"increase",17.13,7,7,0
"2834",1091,2278.61,3789.26,1510.65,"increase",6067.87,2536,1028,1508
"2835",1243,4438.98,4322.26,-116.72,"increase",8761.24,2201,1138,1063
"2836",1397,2388.46,3874.57,1486.11,"increase",6263.03,1982,779,1203
"2837",1570,7613.89,8758.41,1144.52,"increase",16372.3,5527,2479,3048
"2838",2323,3840.53,4151.25,310.72,"increase",7991.78,2987,1429,1558
"2839",2445,3920.12,4897.73,977.610000000001,"increase",8817.85,2959,1402,1557
"2840",2448,0,2.98,2.98,"increase",2.98,2,0,2
"2841",2594,5824.12,4031.85,-1792.27,"increase",9855.97,2744,1666,1078
"2842",2693,2250.24,3146.77,896.53,"increase",5397.01,2010,868,1142
"2843",2844,8099.59,6286.1,-1813.49,"increase",14385.69,6458,3487,2971
"2844",3283,2223.1,2706.4,483.3,"increase",4929.5,2161,934,1227
"2845",3305,1465.08,1516.11,51.0300000000002,"increase",2981.19,1207,619,588
"2846",3390,2862.99,2684.25,-178.74,"increase",5547.24,2435,1189,1246
"2847",3480,17181.14,18262.67,1081.53,"increase",35443.81,13927,6766,7161
"2848",3528,1940.68,1667.79,-272.89,"increase",3608.47,1344,692,652
"2849",3796,2338.33,1790.47,-547.86,"increase",4128.8,1302,671,631
"2850",3856,1019.85,1532.84,512.99,"increase",2552.69,1297,560,737
"2851",4000,3619.21,2424.04,-1195.17,"increase",6043.25,2094,1204,890
"2852",4367,2627.25,3254.29,627.04,"increase",5881.54,2395,1172,1223
"2853",49,0,7.82,7.82,"increase",7.82,4,0,4
"2854",652,2101.74,1879.72,-222.02,"increase",3981.46,2006,995,1011
"2855",846,2224.35,2904.87,680.52,"increase",5129.22,2023,836,1187
"2856",1246,2329.13,2068.14,-260.99,"increase",4397.27,1892,1022,870
"2857",1478,0,19.9,19.9,"increase",19.9,10,0,10
"2858",1511,5114.94,4114.28,-1000.66,"increase",9229.22,3801,2011,1790
"2859",1525,51.18,73.29,22.11,"increase",124.47,35,15,20
"2860",1586,6272.28,5991.81,-280.469999999999,"increase",12264.09,3222,1663,1559
"2861",1644,4404.45,5106,701.55,"increase",9510.45,2763,1260,1503
"2862",1728,3606.49,2709.14,-897.35,"increase",6315.63,3207,1740,1467
"2863",1854,2053.02,2740.34,687.32,"increase",4793.36,2270,930,1340
"2864",1952,40.3,0,-40.3,"increase",40.3,20,20,0
"2865",2076,2996.72,3612.29,615.57,"increase",6609.01,3284,1505,1779
"2866",2088,7290.13,6064.53,-1225.6,"increase",13354.66,3975,2179,1796
"2867",2606,5741.51,4077.54,-1663.97,"increase",9819.05,3286,1867,1419
"2868",2772,2967.1,2291.01,-676.09,"increase",5258.11,1445,913,532
"2869",2922,5353.63,1963.26,-3390.37,"increase",7316.89,2824,2130,694
"2870",3071,6666.59,6404.3,-262.29,"increase",13070.89,3918,2048,1870
"2871",3492,1912.42,2413.6,501.18,"increase",4326.02,1949,882,1067
"2872",4356,3833.26,3829.28,-3.98000000000002,"increase",7662.54,2133,1088,1045
"2873",4437,3375.93,3311.71,-64.2199999999998,"increase",6687.64,2195,1082,1113
"2874",4552,65.98,16.98,-49,"increase",82.96,18,16,2
"2875",4585,2327.27,1922.96,-404.31,"increase",4250.23,1755,969,786
"2876",4591,10827.78,8805.13,-2022.65,"increase",19632.91,9186,4947,4239
"2877",4668,4524.46,3261.25,-1263.21,"increase",7785.71,2260,1309,951
"2878",4702,3606.09,2170.62,-1435.47,"increase",5776.71,2280,1506,774
"2879",4955,1735.63,1932.44,196.81,"increase",3668.07,1876,842,1034
"2880",51,194.19,0,-194.19,"increase",194.19,52,52,0
"2881",653,5079.6,4207.97,-871.63,"increase",9287.57,4142,2240,1902
"2882",1014,4174.97,3064.65,-1110.32,"increase",7239.62,2761,1619,1142
"2883",1915,6115.94,6642.65,526.71,"increase",12758.59,3901,1911,1990
"2884",2110,3898.19,3526.8,-371.39,"increase",7424.99,3156,1621,1535
"2885",2956,5477.75,6239.69,761.940000000001,"increase",11717.44,4243,1971,2272
"2886",4026,3605.06,2986.91,-618.15,"increase",6591.97,1913,1107,806
"2887",4301,2876.57,2674.12,-202.45,"increase",5550.69,2106,1113,993
"2888",4641,4531.27,5055.9,524.63,"increase",9587.17,2964,1371,1593
"2889",4678,2789.86,3434.96,645.1,"increase",6224.82,1834,825,1009
"2890",4936,3398.23,3838.88,440.65,"increase",7237.11,2950,1371,1579
"2891",1056,64.33,0,-64.33,"increase",64.33,22,22,0
"2892",1559,6500.73,4364.96,-2135.77,"increase",10865.69,2848,1607,1241
"2893",2004,1669.54,4171.42,2501.88,"increase",5840.96,2365,695,1670
"2894",2188,4992.85,3706.15,-1286.7,"increase",8699,2555,1522,1033
"2895",2558,3181.97,3259.05,77.0799999999999,"increase",6441.02,2413,1255,1158
"2896",2608,9623.74,8568.13,-1055.61,"increase",18191.87,6585,3579,3006
"2897",2999,7793.47,7313.76,-479.71,"increase",15107.23,5828,3096,2732
"2898",3203,0,51.09,51.09,"increase",51.09,15,0,15
"2899",3443,5229.56,8147.87,2918.31,"increase",13377.43,4900,1868,3032
"2900",3468,3838.45,2323.96,-1514.49,"increase",6162.41,2216,1463,753
"2901",3883,4769.66,3933.57,-836.09,"increase",8703.23,2769,1489,1280
"2902",4317,3406,3162.66,-243.34,"increase",6568.66,2477,1335,1142
"2903",4331,0,18.58,18.58,"increase",18.58,2,0,2
"2904",172,118.86,589.96,471.1,"increase",708.82,363,68,295
"2905",1385,4339.19,4744.28,405.09,"increase",9083.47,4721,2300,2421
"2906",2376,5764.61,6220.48,455.870000000001,"increase",11985.09,5987,2950,3037
"2907",2879,6501.11,6940.5,439.39,"increase",13441.61,4163,1931,2232
"2908",3151,6344.32,6161.47,-182.849999999999,"increase",12505.79,4013,2041,1972
"2909",4675,3959.09,5722.65,1763.56,"increase",9681.74,5769,2399,3370
"2910",272,6403.61,7868.13,1464.52,"increase",14271.74,3367,1704,1663
"2911",1142,2.75,2.49,-0.26,"increase",5.24,3,1,2
"2912",2607,2281.24,2195.11,-86.1300000000001,"increase",4476.35,4274,2162,2112
"2913",3083,100.84,168.4,67.56,"increase",269.24,108,34,74
"2914",3655,10823.91,10109.09,-714.82,"increase",20933,6356,3381,2975
"2915",29,3058.68,3030.75,-27.9299999999998,"increase",6089.43,2929,1510,1419
"2916",106,0,92.56,92.56,"increase",92.56,22,0,22
"2917",231,3688.1,4294.19,606.090000000001,"increase",7982.29,3243,1596,1647
"2918",384,8400.34,7282.42,-1117.92,"increase",15682.76,5926,3184,2742
"2919",589,500.28,69.87,-430.41,"increase",570.15,164,123,41
"2920",899,3414.82,3967.29,552.47,"increase",7382.11,2434,1094,1340
"2921",1083,25.74,0,-25.74,"increase",25.74,7,7,0
"2922",1105,4393.99,4088.86,-305.13,"increase",8482.85,2648,1268,1380
"2923",1231,4983.48,4797.38,-186.1,"increase",9780.86,3035,1550,1485
"2924",1495,10033.38,12296.97,2263.59,"increase",22330.35,8164,3983,4181
"2925",1710,1156.18,1080.99,-75.1900000000001,"increase",2237.17,1259,694,565
"2926",1751,5821.19,4292.73,-1528.46,"increase",10113.92,4954,2747,2207
"2927",2164,4699.78,6405.36,1705.58,"increase",11105.14,4159,1780,2379
"2928",2167,5116.42,4472.15,-644.27,"increase",9588.57,2534,1353,1181
"2929",2828,9765.66,8669.24,-1096.42,"increase",18434.9,9183,4979,4204
"2930",3003,4375.2,5605.1,1229.9,"increase",9980.3,4497,1910,2587
"2931",3294,1503.23,480.97,-1022.26,"increase",1984.2,649,487,162
"2932",3373,3962.52,4918.79,956.27,"increase",8881.31,3448,1531,1917
"2933",3579,2493.95,2894.93,400.98,"increase",5388.88,2138,926,1212
"2934",3800,2753.67,3795.19,1041.52,"increase",6548.86,1932,843,1089
"2935",3822,4510.7,6090.75,1580.05,"increase",10601.45,4106,1828,2278
"2936",4011,4063.65,4023.68,-39.9700000000003,"increase",8087.33,3540,1768,1772
"2937",4029,1498.09,1327.43,-170.66,"increase",2825.52,1476,762,714
"2938",4253,24.21,0,-24.21,"increase",24.21,8,8,0
"2939",4319,2484.52,2986.27,501.75,"increase",5470.79,1873,795,1078
"2940",4518,1.99,0,-1.99,"increase",1.99,1,1,0
"2941",4616,3572.87,4450.14,877.27,"increase",8023.01,2739,1146,1593
"2942",301,3372.33,3235.16,-137.17,"increase",6607.49,2534,1324,1210
"2943",346,4551.65,4194.8,-356.849999999999,"increase",8746.45,2503,1285,1218
"2944",365,49.84,0,-49.84,"increase",49.84,59,59,0
"2945",485,5.99,0,-5.99,"increase",5.99,2,2,0
"2946",550,4539.75,4635.47,95.7200000000003,"increase",9175.22,2991,1466,1525
"2947",1036,2504.11,2896.68,392.57,"increase",5400.79,2410,1188,1222
"2948",1229,4886.74,4624.15,-262.59,"increase",9510.89,4458,2282,2176
"2949",1280,3996.04,5198,1201.96,"increase",9194.04,3192,1478,1714
"2950",2281,4454.36,3644.65,-809.71,"increase",8099.01,2644,1443,1201
"2951",2649,5116.87,6672.48,1555.61,"increase",11789.35,5793,2911,2882
"2952",2980,2700.67,2232.77,-467.9,"increase",4933.44,2360,1305,1055
"2953",2984,1528.22,2004.94,476.72,"increase",3533.16,1945,841,1104
"2954",3577,2449.15,3906.97,1457.82,"increase",6356.12,2161,864,1297
"2955",3635,1782.73,1733.17,-49.5599999999999,"increase",3515.9,1162,574,588
"2956",3758,1838.56,1678.12,-160.44,"increase",3516.68,977,514,463
"2957",3982,3155.21,5459.99,2304.78,"increase",8615.2,3684,1389,2295
"2958",4117,2168.81,2106.92,-61.8899999999999,"increase",4275.73,1789,938,851
"2959",4311,2581.64,2039.72,-541.92,"increase",4621.36,1738,1059,679
"2960",4500,2339.98,2948.12,608.14,"increase",5288.1,2665,1218,1447
"2961",4642,8804.4,7893.49,-910.91,"increase",16697.89,5945,3191,2754
"2962",4651,2487.71,2541.58,53.8699999999999,"increase",5029.29,1433,718,715
"2963",694,14626.44,17347.91,2721.47,"increase",31974.35,10277,4984,5293
"2964",710,4691.07,4190.25,-500.82,"increase",8881.32,2298,1217,1081
"2965",714,5340.83,4856.79,-484.04,"increase",10197.62,3661,2021,1640
"2966",902,3790.21,4568.62,778.41,"increase",8358.83,3260,1526,1734
"2967",963,0,22.1,22.1,"increase",22.1,13,0,13
"2968",996,3376.49,3070.5,-305.99,"increase",6446.99,3753,1985,1768
"2969",1057,2070.25,3153.39,1083.14,"increase",5223.64,1965,809,1156
"2970",1473,1508.27,1854.83,346.56,"increase",3363.1,1424,679,745
"2971",2528,4845.92,5514.19,668.27,"increase",10360.11,2985,1418,1567
"2972",3118,0,40.19,40.19,"increase",40.19,19,0,19
"2973",3385,2588.15,1770.7,-817.45,"increase",4358.85,1416,783,633
"2974",3411,48.63,6.98,-41.65,"increase",55.61,19,15,4
"2975",4119,1937.28,876.93,-1060.35,"increase",2814.21,912,635,277
"2976",39,5627.36,5227.5,-399.86,"increase",10854.86,3704,1894,1810
"2977",877,3608.25,3702.95,94.7000000000003,"increase",7311.2,2054,1024,1030
"2978",972,0,79.02,79.02,"increase",79.02,24,0,24
"2979",1967,224.55,13.99,-210.56,"increase",238.54,59,58,1
"2980",3097,7898.59,6235.13,-1663.46,"increase",14133.72,3857,2177,1680
"2981",3352,2092.77,2038.6,-54.1699999999998,"increase",4131.37,1242,564,678
"2982",4827,7521.73,4632.16,-2889.57,"increase",12153.89,3700,2214,1486
"2983",100,215.12,108.79,-106.33,"increase",323.91,120,78,42
"2984",557,562.01,879.58,317.57,"increase",1441.59,399,156,243
"2985",1338,3648.44,2424.28,-1224.16,"increase",6072.72,2016,1229,787
"2986",1627,4868.64,5496.19,627.549999999999,"increase",10364.83,3674,1770,1904
"2987",2563,1948.24,2663.76,715.52,"increase",4612,3323,1505,1818
"2988",2664,5811.87,6056.5,244.63,"increase",11868.37,4826,2388,2438
"2989",4654,1286,1476.62,190.62,"increase",2762.62,1205,598,607
"2990",3741,21.85,19.44,-2.41,"increase",41.29,12,7,5
"2991",4483,75.14,122.18,47.04,"increase",197.32,69,30,39
"2992",304,3830.47,3665.31,-165.16,"increase",7495.78,2559,1314,1245
"2993",1701,3407.73,4484.69,1076.96,"increase",7892.42,2557,1083,1474
"2994",1808,2944.19,2915.71,-28.48,"increase",5859.9,1734,848,886
"2995",3033,13832.85,11507.9,-2324.95,"increase",25340.75,9189,4866,4323
"2996",3643,3378.9,3655.01,276.11,"increase",7033.91,2476,1184,1292
"2997",4886,3438.86,3416.34,-22.52,"increase",6855.2,3370,1692,1678
"2998",1126,57.56,0,-57.56,"increase",57.56,19,19,0
"2999",1870,2113.23,1244.61,-868.62,"increase",3357.84,1278,859,419
"3000",2706,5584.06,3057.03,-2527.03,"increase",8641.09,3433,2351,1082
"3001",3730,3943.02,5671.59,1728.57,"increase",9614.61,2601,1059,1542
"3002",4775,8151.49,7514.5,-636.99,"increase",15665.99,4594,2468,2126
"3003",1097,0,5.97,5.97,"increase",5.97,3,0,3
"3004",1135,0,45.97,45.97,"increase",45.97,17,0,17
"3005",3078,6962.16,7070.94,108.780000000001,"increase",14033.1,4010,2009,2001
"3006",27,4865.53,4119.86,-745.67,"increase",8985.39,3524,1718,1806
"3007",324,5406.23,6254.3,848.07,"increase",11660.53,3241,1471,1770
"3008",462,6233.59,5017.37,-1216.22,"increase",11250.96,3202,1702,1500
"3009",486,73.18,64.98,-8.2,"increase",138.16,35,23,12
"3010",732,9246.26,7556.01,-1690.25,"increase",16802.27,4202,2182,2020
"3011",766,1809.99,2006.33,196.34,"increase",3816.32,2138,904,1234
"3012",815,3013.94,2660.89,-353.05,"increase",5674.83,2049,1107,942
"3013",888,2693.47,2323,-370.47,"increase",5016.47,2166,1161,1005
"3014",911,3390.46,4386.06,995.6,"increase",7776.52,2502,1158,1344
"3015",924,3060.33,2092.43,-967.9,"increase",5152.76,2859,1747,1112
"3016",985,9897.29,8641.59,-1255.7,"increase",18538.88,5444,3080,2364
"3017",1088,0,169.75,169.75,"increase",169.75,83,0,83
"3018",1857,7653.76,8680.28,1026.52,"increase",16334.04,5085,2476,2609
"3019",2048,5234.22,6359.64,1125.42,"increase",11593.86,3708,1696,2012
"3020",2069,7244.26,5632.79,-1611.47,"increase",12877.05,4008,2362,1646
"3021",2392,2563.37,2602.42,39.0500000000002,"increase",5165.79,2195,1070,1125
"3022",2610,1899.45,2505.5,606.05,"increase",4404.95,1502,581,921
"3023",2698,3786.59,3768.81,-17.7800000000002,"increase",7555.4,2182,1140,1042
"3024",3260,7160.43,7001.9,-158.530000000001,"increase",14162.33,5677,2925,2752
"3025",3582,3560.91,3303.58,-257.33,"increase",6864.49,2004,1058,946
"3026",3792,5465.12,5860.13,395.01,"increase",11325.25,3521,1720,1801
"3027",3955,5225.32,6087.55,862.23,"increase",11312.87,4727,2297,2430
"3028",4381,9619.09,10799.18,1180.09,"increase",20418.27,7680,3670,4010
"3029",4801,2036.93,1992.17,-44.76,"increase",4029.1,2117,1084,1033
"3030",4874,4332.06,2340.28,-1991.78,"increase",6672.34,2700,1671,1029
"3031",4758,5790.06,5590.68,-199.38,"increase",11380.74,4697,2501,2196
"3032",568,11.99,359.73,347.74,"increase",371.72,86,3,83
"3033",1622,2509.61,2413.9,-95.71,"increase",4923.51,2429,1260,1169
"3034",1980,5320.51,3084.19,-2236.32,"increase",8404.7,2804,1727,1077
"3035",2049,2909.26,5190.69,2281.43,"increase",8099.95,3113,1311,1802
"3036",2176,583.71,502.57,-81.14,"increase",1086.28,211,81,130
"3037",2356,7535.26,9048.49,1513.23,"increase",16583.75,7512,3435,4077
"3038",2489,3591.94,4132.6,540.66,"increase",7724.54,3227,1444,1783
"3039",3165,2436.01,1672.7,-763.31,"increase",4108.71,2303,1317,986
"3040",3556,1798.86,2161,362.14,"increase",3959.86,1529,644,885
"3041",4213,5089.78,2084.53,-3005.25,"increase",7174.31,1862,1343,519
"3042",4440,2127.98,2471.12,343.14,"increase",4599.1,1784,833,951
"3043",678,3431.04,4163.51,732.47,"increase",7594.55,5066,2277,2789
"3044",1496,5245.42,4056.38,-1189.04,"increase",9301.8,4339,2629,1710
"3045",1541,2112.65,1930.96,-181.69,"increase",4043.61,1988,1052,936
"3046",1543,8.48,0,-8.48,"increase",8.48,2,2,0
"3047",2128,712.49,706.86,-5.63,"increase",1419.35,613,338,275
"3048",2134,2963.01,3246.26,283.25,"increase",6209.27,2591,1260,1331
"3049",2184,3141.96,8868.01,5726.05,"increase",12009.97,3336,943,2393
"3050",2278,5024.51,4378.34,-646.17,"increase",9402.85,4697,2786,1911
"3051",2846,3994.21,3916.34,-77.8699999999999,"increase",7910.55,3730,2011,1719
"3052",4247,2666.66,1824.39,-842.27,"increase",4491.05,2286,1331,955
"3053",4466,253.01,23.56,-229.45,"increase",276.57,107,103,4
"3054",4469,4820.38,9276.96,4456.58,"increase",14097.34,5195,1720,3475
"3055",4696,3998.87,2675.52,-1323.35,"increase",6674.39,3018,1676,1342
"3056",4707,2146.13,2068.34,-77.79,"increase",4214.47,1750,883,867
"3057",4720,4225.67,4118.35,-107.32,"increase",8344.02,2765,1468,1297
"3058",4824,3863.6,2946.74,-916.86,"increase",6810.34,2737,1588,1149
"3059",4834,1104.66,803.18,-301.48,"increase",1907.84,1161,610,551
"3060",1633,4489.68,7389.21,2899.53,"increase",11878.89,4592,1825,2767
"3061",2294,2188.33,2994.95,806.62,"increase",5183.28,1600,699,901
"3062",2512,14.37,16.03,1.66,"increase",30.4,13,4,9
"3063",4340,4422.97,4501.91,78.9399999999996,"increase",8924.88,3104,1478,1626
"3064",4561,2996.14,4624.19,1628.05,"increase",7620.33,2533,905,1628
"3065",4884,0,35.38,35.38,"increase",35.38,14,0,14
"3066",3886,7872.01,7102.32,-769.690000000001,"increase",14974.33,4615,2442,2173
"3067",803,8167.68,9788.59,1620.91,"increase",17956.27,6397,2983,3414
"3068",862,4061.82,5339.54,1277.72,"increase",9401.36,3703,1673,2030
"3069",2372,3575.59,2355.93,-1219.66,"increase",5931.52,2428,1361,1067
"3070",2501,4102.97,4251.1,148.13,"increase",8354.07,2940,1453,1487
"3071",2748,2800.99,2429.57,-371.42,"increase",5230.56,3289,1880,1409
"3072",3473,2462.77,2121.67,-341.1,"increase",4584.44,2222,1248,974
"3073",3778,7082.82,6824.39,-258.429999999999,"increase",13907.21,3907,2066,1841
"3074",4420,5893.85,5610.8,-283.05,"increase",11504.65,4310,2208,2102
"3075",4615,8172.08,8700.41,528.33,"increase",16872.49,6264,3072,3192
"3076",4903,2762.99,2508.21,-254.78,"increase",5271.2,1363,680,683
"3077",1155,3988.76,3604.66,-384.1,"increase",7593.42,2188,1128,1060
"3078",4293,269.38,209.7,-59.68,"increase",479.08,172,99,73
"3079",416,3590.31,4278.8,688.49,"increase",7869.11,3199,1482,1717
"3080",500,2215.22,2062.5,-152.72,"increase",4277.72,2534,1309,1225
"3081",1283,2617.24,1916.86,-700.38,"increase",4534.1,1767,1042,725
"3082",3377,2821.47,2390.71,-430.76,"increase",5212.18,1534,799,735
"3083",3928,3737.12,3978.79,241.67,"increase",7715.91,3644,1778,1866
"3084",4664,4502.69,3779.67,-723.02,"increase",8282.36,3516,1895,1621
"3085",4764,2883.43,2416.71,-466.72,"increase",5300.14,2228,1228,1000
"3086",1602,4856.4,6172.13,1315.73,"increase",11028.53,3511,1654,1857
"3087",1823,3705.87,3606.13,-99.7399999999998,"increase",7312,2835,1427,1408
"3088",534,1730.75,1881.68,150.93,"increase",3612.43,1275,579,696
"3089",3875,14222.67,11331.43,-2891.24,"increase",25554.1,8212,4622,3590
"3090",4110,0,1.99,1.99,"increase",1.99,1,0,1
"3091",4227,3151.77,4096.75,944.98,"increase",7248.52,3076,1321,1755
"3092",4333,3.99,53.07,49.08,"increase",57.06,37,3,34
"3093",4612,5229.6,6290.02,1060.42,"increase",11519.62,4379,1926,2453
"3094",358,5087.03,4883,-204.03,"increase",9970.03,3533,1800,1733
"3095",548,4932.21,4268.66,-663.55,"increase",9200.87,4249,2265,1984
"3096",1533,2881.19,3269.43,388.24,"increase",6150.62,2462,1089,1373
"3097",2678,3997.98,4264.4,266.42,"increase",8262.38,3170,1543,1627
"3098",3354,6997.95,7792.1,794.150000000001,"increase",14790.05,6649,3066,3583
"3099",157,5974.51,6678.55,704.04,"increase",12653.06,4372,2035,2337
"3100",159,1346.3,1487.35,141.05,"increase",2833.65,1016,433,583
"3101",1529,53.33,0,-53.33,"increase",53.33,13,13,0
"3102",1579,4477.43,3815.03,-662.4,"increase",8292.46,3070,1607,1463
"3103",2147,3883.89,2160.01,-1723.88,"increase",6043.9,2558,1516,1042
"3104",3915,79.76,70.36,-9.40000000000001,"increase",150.12,43,26,17
"3105",1698,53.78,40.28,-13.5,"increase",94.06,32,15,17
"3106",4854,4158.13,6625.52,2467.39,"increase",10783.65,3296,1460,1836
"3107",397,2.99,0,-2.99,"increase",2.99,1,1,0
"3108",1828,5837.5,5567.62,-269.88,"increase",11405.12,4652,2286,2366
"3109",1841,4010.57,4627.23,616.66,"increase",8637.8,3007,1446,1561
"3110",3022,624.12,862.77,238.65,"increase",1486.89,576,229,347
"3111",4315,5416.9,6690.12,1273.22,"increase",12107.02,4570,1931,2639
"3112",4569,4291.78,4152.34,-139.44,"increase",8444.12,3492,1804,1688
"3113",4752,4536.28,3171.56,-1364.72,"increase",7707.84,2449,1496,953
"3114",800,8152.67,6903.97,-1248.7,"increase",15056.64,4683,2426,2257
"3115",1684,0,11.49,11.49,"increase",11.49,1,0,1
"3116",1896,5886.8,6875.97,989.17,"increase",12762.77,4177,1900,2277
"3117",2005,3192.22,2987.22,-205,"increase",6179.44,2645,1306,1339
"3118",2289,7323.64,7923.33,599.69,"increase",15246.97,6752,3123,3629
"3119",3351,4173.62,2144.28,-2029.34,"increase",6317.9,2081,1347,734
"3120",4146,10935.57,12774.59,1839.02,"increase",23710.16,5906,2847,3059
"3121",4434,5991.55,4217.05,-1774.5,"increase",10208.6,3454,2041,1413
"3122",4629,6163.04,6841.03,677.99,"increase",13004.07,6472,2920,3552
"3123",262,88.92,0,-88.92,"increase",88.92,32,32,0
"3124",1872,10825.71,12097.62,1271.91,"increase",22923.33,7813,3856,3957
"3125",2418,8510.44,8950.92,440.48,"increase",17461.36,5674,2872,2802
"3126",4093,9178.11,7909.2,-1268.91,"increase",17087.31,5769,3200,2569
"3127",4462,2795.13,2964.29,169.16,"increase",5759.42,1602,826,776
"3128",4540,7.47,0,-7.47,"increase",7.47,3,3,0
"3129",363,5417.87,5527.93,110.06,"increase",10945.8,4236,2059,2177
"3130",812,4688.58,3936.39,-752.19,"increase",8624.97,2892,1609,1283
"3131",1207,7707.01,6328.75,-1378.26,"increase",14035.76,4569,2585,1984
"3132",1309,3599.99,5094.95,1494.96,"increase",8694.94,2830,1208,1622
"3133",1316,7058.99,4159.63,-2899.36,"increase",11218.62,4637,3152,1485
"3134",1600,3227.94,2863.61,-364.33,"increase",6091.55,2348,1271,1077
"3135",1827,3172,2694.48,-477.52,"increase",5866.48,2257,1135,1122
"3136",1899,2653.15,3497.74,844.59,"increase",6150.89,2962,1261,1701
"3137",2010,12643.48,15568.67,2925.19,"increase",28212.15,6735,3058,3677
"3138",2491,3703.02,3312.87,-390.15,"increase",7015.89,3511,1844,1667
"3139",2715,3281.69,3257.7,-23.9899999999998,"increase",6539.39,3236,1607,1629
"3140",3427,1352.93,1013.37,-339.56,"increase",2366.3,871,521,350
"3141",3519,4045.97,5693.86,1647.89,"increase",9739.83,3771,1492,2279
"3142",3912,1551.53,1558,6.47000000000003,"increase",3109.53,1812,903,909
"3143",4010,0,81.13,81.13,"increase",81.13,25,0,25
"3144",4162,4982.39,4674.9,-307.490000000001,"increase",9657.29,2986,1509,1477
"3145",4410,5757.99,4223.32,-1534.67,"increase",9981.31,4422,2443,1979
"3146",261,4041.46,4675.13,633.67,"increase",8716.59,3231,1528,1703
"3147",279,6286.36,5487.09,-799.27,"increase",11773.45,3700,1911,1789
"3148",733,1351.1,1287.2,-63.8999999999999,"increase",2638.3,967,532,435
"3149",817,4010.17,3344.88,-665.29,"increase",7355.05,3390,1780,1610
"3150",1038,3093.06,2645.74,-447.32,"increase",5738.8,2097,1052,1045
"3151",1191,4800.96,3124.93,-1676.03,"increase",7925.89,2656,1602,1054
"3152",1216,7454.81,6662.88,-791.93,"increase",14117.69,4750,2614,2136
"3153",1672,4342.63,3579.5,-763.13,"increase",7922.13,3589,1809,1780
"3154",1719,2737,5322.26,2585.26,"increase",8059.26,3532,988,2544
"3155",1796,84.78,0,-84.78,"increase",84.78,33,33,0
"3156",1858,2663.56,4926.66,2263.1,"increase",7590.22,2354,814,1540
"3157",2295,5819.52,7621.17,1801.65,"increase",13440.69,6397,2880,3517
"3158",2302,28.25,118.52,90.27,"increase",146.77,36,5,31
"3159",2317,0,40.05,40.05,"increase",40.05,15,0,15
"3160",2444,181.33,120.35,-60.98,"increase",301.68,107,64,43
"3161",2482,8190.71,8865.36,674.650000000001,"increase",17056.07,4839,2430,2409
"3162",2667,2295.12,12333.92,10038.8,"increase",14629.04,4834,654,4180
"3163",3057,5257.78,4881.45,-376.33,"increase",10139.23,3316,1773,1543
"3164",3184,0,243.24,243.24,"increase",243.24,50,0,50
"3165",3323,23.89,0,-23.89,"increase",23.89,10,10,0
"3166",3688,5514.28,8625.18,3110.9,"increase",14139.46,4434,1774,2660
"3167",4176,57.94,63.77,5.83,"increase",121.71,31,17,14
"3168",4436,2399.9,2085.11,-314.79,"increase",4485.01,1768,949,819
"3169",209,135.88,119.95,-15.93,"increase",255.83,79,36,43
"3170",845,7205.07,8499.77,1294.7,"increase",15704.84,4445,2002,2443
"3171",1383,5052.8,6032.45,979.65,"increase",11085.25,3220,1455,1765
"3172",1515,0,182.56,182.56,"increase",182.56,52,0,52
"3173",1905,8569.79,9124.65,554.859999999999,"increase",17694.44,4725,2224,2501
"3174",2569,11640.3,10722.08,-918.219999999999,"increase",22362.38,6567,3288,3279
"3175",3077,137.46,158.82,21.36,"increase",296.28,99,42,57
"3176",3379,3231.64,5243.74,2012.1,"increase",8475.38,3027,1219,1808
"3177",3776,5356.26,5249.41,-106.85,"increase",10605.67,2434,1174,1260
"3178",4448,0,199.03,199.03,"increase",199.03,58,0,58
"3179",4939,8942.52,8207.54,-734.98,"increase",17150.06,7208,3720,3488
"3180",369,50.96,0,-50.96,"increase",50.96,4,4,0
"3181",374,4069.85,5813.35,1743.5,"increase",9883.2,3764,1627,2137
"3182",454,687.4,4632.51,3945.11,"increase",5319.91,2318,285,2033
"3183",2112,20494.51,16349.87,-4144.64,"increase",36844.38,12508,6882,5626
"3184",46,5797.28,4998.6,-798.679999999999,"increase",10795.88,3318,1790,1528
"3185",968,2877.53,2777.73,-99.8000000000002,"increase",5655.26,2441,1316,1125
"3186",1277,7863.19,8046.09,182.9,"increase",15909.28,5014,2486,2528
"3187",1971,0,3.99,3.99,"increase",3.99,1,0,1
"3188",3141,1412.99,1498.74,85.75,"increase",2911.73,1104,515,589
"3189",4103,3.5,0,-3.5,"increase",3.5,1,1,0
"3190",4221,1930.06,2464.53,534.47,"increase",4394.59,2596,1150,1446
"3191",4290,12231.44,12312.84,81.3999999999996,"increase",24544.28,9160,4579,4581
"3192",4894,3234.21,8355.27,5121.06,"increase",11589.48,4569,1189,3380
"3193",177,11604.17,12907.81,1303.64,"increase",24511.98,8256,3945,4311
"3194",1165,3628.62,4054.6,425.98,"increase",7683.22,2213,1145,1068
"3195",1587,8536.66,11029.76,2493.1,"increase",19566.42,5959,2639,3320
"3196",3271,88.95,13.28,-75.67,"increase",102.23,23,19,4
"3197",3297,1030.52,1423.6,393.08,"increase",2454.12,1048,441,607
"3198",3299,2819.14,3089.8,270.66,"increase",5908.94,2976,1352,1624
"3199",3353,5491.73,5768.71,276.98,"increase",11260.44,5097,2567,2530
"3200",3830,26.99,67.83,40.84,"increase",94.82,44,11,33
"3201",180,7367.65,5265.18,-2102.47,"increase",12632.83,3716,2128,1588
"3202",754,8586.4,7900.55,-685.849999999999,"increase",16486.95,4882,2533,2349
"3203",771,6632.82,4203.25,-2429.57,"increase",10836.07,3887,2256,1631
"3204",969,3647.88,4023.85,375.97,"increase",7671.73,2549,1304,1245
"3205",1018,5923.45,6379.08,455.63,"increase",12302.53,4432,2336,2096
"3206",1081,212.91,130.78,-82.13,"increase",343.69,93,47,46
"3207",1569,2260.58,1314.08,-946.5,"increase",3574.66,1414,918,496
"3208",1581,6208.96,7180.07,971.11,"increase",13389.03,6208,2996,3212
"3209",1670,2310,2879.69,569.69,"increase",5189.69,2572,1168,1404
"3210",1819,2805.7,2668.63,-137.07,"increase",5474.33,2318,1235,1083
"3211",1925,3335.06,3337.8,2.74000000000024,"increase",6672.86,2562,1200,1362
"3212",1966,7493.2,7008.33,-484.87,"increase",14501.53,6370,3169,3201
"3213",3017,1834.37,1787.89,-46.48,"increase",3622.26,1579,820,759
"3214",3450,1692.13,1814.78,122.65,"increase",3506.91,1549,764,785
"3215",3612,8828.34,8180.37,-647.97,"increase",17008.71,5040,2561,2479
"3216",4763,4316.97,7155.37,2838.4,"increase",11472.34,4022,1680,2342
"3217",4876,7137.95,3774.46,-3363.49,"increase",10912.41,3808,2368,1440
"3218",518,3651.78,3143.27,-508.51,"increase",6795.05,2402,1186,1216
"3219",831,3928.16,3478.34,-449.82,"increase",7406.5,4183,2276,1907
"3220",904,13099.79,10157.59,-2942.2,"increase",23257.38,6014,3267,2747
"3221",1374,4935.72,5826.93,891.21,"increase",10762.65,3885,1749,2136
"3222",1632,4044.61,4891.07,846.46,"increase",8935.68,2604,1197,1407
"3223",2246,3969.41,3855.07,-114.34,"increase",7824.48,2637,1388,1249
"3224",2410,2295.68,3430.54,1134.86,"increase",5726.22,1839,797,1042
"3225",2421,20.85,0,-20.85,"increase",20.85,8,8,0
"3226",2567,8624.29,8575.7,-48.5900000000001,"increase",17199.99,5281,2560,2721
"3227",3065,2459.16,2453.39,-5.76999999999998,"increase",4912.55,1860,958,902
"3228",3090,7361.66,7405.22,43.5600000000004,"increase",14766.88,5370,2608,2762
"3229",3327,3914.85,7285.81,3370.96,"increase",11200.66,3382,1217,2165
"3230",3929,2494.35,3599.36,1105.01,"increase",6093.71,4278,1768,2510
"3231",4006,5014.8,4030.62,-984.18,"increase",9045.42,4012,2182,1830
"3232",4136,2584.53,2460.49,-124.04,"increase",5045.02,2112,1071,1041
"3233",4282,5058.39,5394.57,336.179999999999,"increase",10452.96,5819,2878,2941
"3234",4297,4203.15,5662.91,1459.76,"increase",9866.06,3925,1697,2228
"3235",252,0,34.36,34.36,"increase",34.36,9,0,9
"3236",342,3004.35,4241.78,1237.43,"increase",7246.13,2654,1082,1572
"3237",1048,10952.57,12665.54,1712.97,"increase",23618.11,5594,2643,2951
"3238",1723,3685.14,4224.92,539.78,"increase",7910.06,4068,1791,2277
"3239",1866,25.28,0,-25.28,"increase",25.28,14,14,0
"3240",2097,3548.3,3922.61,374.31,"increase",7470.91,2416,1187,1229
"3241",2233,6164.31,7343.73,1179.42,"increase",13508.04,4271,1919,2352
"3242",2309,4722.38,3824.21,-898.17,"increase",8546.59,2542,1309,1233
"3243",2856,4286.2,3637,-649.2,"increase",7923.2,3699,2035,1664
"3244",2993,3324.95,4687.97,1363.02,"increase",8012.92,2855,1203,1652
"3245",3110,1744.88,1850.13,105.25,"increase",3595.01,1158,558,600
"3246",3207,6419.41,5421.93,-997.48,"increase",11841.34,3620,2079,1541
"3247",3535,2679.73,2000.27,-679.46,"increase",4680,1793,1025,768
"3248",3909,6881.14,7308.83,427.69,"increase",14189.97,5883,3043,2840
"3249",4161,5600.58,6242.19,641.610000000001,"increase",11842.77,4499,2268,2231
"3250",4241,704.63,934.28,229.65,"increase",1638.91,456,218,238
"3251",990,10.27,27.79,17.52,"increase",38.06,16,5,11
"3252",3080,11132.75,9728.35,-1404.4,"increase",20861.1,6175,3202,2973
"3253",3707,3637.86,3238.57,-399.29,"increase",6876.43,3289,1660,1629
"3254",4220,12043.33,13187.91,1144.58,"increase",25231.24,6579,3029,3550
"3255",4753,3715.12,5820.51,2105.39,"increase",9535.63,3758,1567,2191
"3256",141,29.6,26.18,-3.42,"increase",55.78,16,7,9
"3257",1004,2885.69,916.62,-1969.07,"increase",3802.31,1483,1140,343
"3258",1517,141.69,0,-141.69,"increase",141.69,69,69,0
"3259",3583,2679.21,1910.63,-768.58,"increase",4589.84,2055,1205,850
"3260",3797,3125.86,3782.43,656.57,"increase",6908.29,4014,1905,2109
"3261",4656,20.59,0,-20.59,"increase",20.59,5,5,0
"3262",1748,2613.77,4405.62,1791.85,"increase",7019.39,2198,766,1432
"3263",2338,1564.16,1598.63,34.47,"increase",3162.79,1036,529,507
"3264",2350,5020.61,3613.28,-1407.33,"increase",8633.89,2307,1400,907
"3265",2464,524.09,97.7,-426.39,"increase",621.79,169,142,27
"3266",4337,4408.89,3814.94,-593.95,"increase",8223.83,2634,1472,1162
"3267",31,0,16.67,16.67,"increase",16.67,6,0,6
"3268",889,1450.55,1773.19,322.64,"increase",3223.74,1520,733,787
"3269",1843,0,15.65,15.65,"increase",15.65,7,0,7
"3270",1953,6934.92,8108.27,1173.35,"increase",15043.19,3959,1748,2211
"3271",1976,0,32.56,32.56,"increase",32.56,11,0,11
"3272",2599,6786.99,5922.72,-864.27,"increase",12709.71,5277,2977,2300
"3273",3137,2901.24,3587.6,686.36,"increase",6488.84,2431,1028,1403
"3274",3602,60.18,53.44,-6.74,"increase",113.62,38,21,17
"3275",3894,9741.87,11604.15,1862.28,"increase",21346.02,7260,3036,4224
"3276",4140,7099.42,5822.01,-1277.41,"increase",12921.43,4266,2383,1883
"3277",4201,21.38,0,-21.38,"increase",21.38,4,4,0
"3278",4556,2219.52,2760.94,541.42,"increase",4980.46,2354,1120,1234
"3279",4666,10088.94,6251.94,-3837,"increase",16340.88,5702,3576,2126
"3280",408,3027.48,2816.81,-210.67,"increase",5844.29,2385,1201,1184
"3281",734,2054.6,2312.49,257.89,"increase",4367.09,2295,1120,1175
"3282",952,6222.1,6952.76,730.66,"increase",13174.86,6982,3390,3592
"3283",1039,2636.57,2117.83,-518.74,"increase",4754.4,2170,1205,965
"3284",1455,5888.98,5367,-521.98,"increase",11255.98,3917,2136,1781
"3285",2774,4695.42,5011.36,315.94,"increase",9706.78,4477,2186,2291
"3286",3031,1409.84,1229.34,-180.5,"increase",2639.18,1554,858,696
"3287",3463,7834.13,8841.34,1007.21,"increase",16675.47,6229,2958,3271
"3288",3637,2579.08,3279.53,700.45,"increase",5858.61,1593,741,852
"3289",4154,3926.34,4459.41,533.07,"increase",8385.75,3736,1649,2087
"3290",4841,2051.85,1895.65,-156.2,"increase",3947.5,2169,1101,1068
"3291",1518,2816.53,5363.32,2546.79,"increase",8179.85,2882,1107,1775
"3292",377,0,24.57,24.57,"increase",24.57,3,0,3
"3293",1568,17.99,18.49,0.5,"increase",36.48,2,1,1
"3294",2399,0,71.74,71.74,"increase",71.74,18,0,18
"3295",2699,5254.04,6982.44,1728.4,"increase",12236.48,3875,1747,2128
"3296",3355,0,40.95,40.95,"increase",40.95,5,0,5
"3297",479,0,131.98,131.98,"increase",131.98,39,0,39
"3298",1214,3642.1,1736.48,-1905.62,"increase",5378.58,1875,1277,598
"3299",1282,3304.89,2557.39,-747.5,"increase",5862.28,2030,1127,903
"3300",1991,5814.06,6694.29,880.23,"increase",12508.35,4027,2077,1950
"3301",2587,2741.91,2022.44,-719.47,"increase",4764.35,2283,1366,917
"3302",2824,7760.07,6517.87,-1242.2,"increase",14277.94,7472,4047,3425
"3303",3424,5356.29,4392.34,-963.95,"increase",9748.63,4177,2197,1980
"3304",597,3930.5,4940.14,1009.64,"increase",8870.64,2484,1122,1362
"3305",2107,2926.81,4184.94,1258.13,"increase",7111.75,2858,1219,1639
"3306",2580,2220.94,2609.96,389.02,"increase",4830.9,2096,920,1176
"3307",2853,4023.77,7451.39,3427.62,"increase",11475.16,4024,1667,2357
"3308",912,2971.23,3324.02,352.79,"increase",6295.25,2509,1171,1338
"3309",2530,2967.14,2091.66,-875.48,"increase",5058.8,1890,1061,829
"3310",1479,6453.97,8161.52,1707.55,"increase",14615.49,4173,1922,2251
"3311",3232,94.46,913.31,818.85,"increase",1007.77,301,32,269
"3312",567,1631.14,1881.62,250.48,"increase",3512.76,2348,938,1410
"3313",1651,6349.79,6828.84,479.05,"increase",13178.63,4120,2009,2111
"3314",2051,6142.1,6049.36,-92.7400000000007,"increase",12191.46,7053,3516,3537
"3315",2182,250.81,114.86,-135.95,"increase",365.67,118,89,29
"3316",2895,2360.02,2398.6,38.5799999999999,"increase",4758.62,1408,721,687
"3317",2884,2540.2,2731.73,191.53,"increase",5271.93,2052,943,1109
"3318",4450,0,29.81,29.81,"increase",29.81,7,0,7
"3319",3421,5034.5,6678.36,1643.86,"increase",11712.86,4210,1876,2334
"3320",3108,8272.67,4993.26,-3279.41,"increase",13265.93,5162,3184,1978
"3321",3757,2746.5,1793.68,-952.82,"increase",4540.18,1520,931,589
"3322",4135,8247.29,8305.12,57.8299999999999,"increase",16552.41,6163,3045,3118
"3323",4455,5399.26,1992.52,-3406.74,"increase",7391.78,2567,1977,590
"3324",1272,9893.27,5547.3,-4345.97,"increase",15440.57,7178,4200,2978
"3325",4160,0,50.37,50.37,"increase",50.37,19,0,19
"3326",3951,1812.2,5654.04,3841.84,"increase",7466.24,2367,590,1777
"3327",4438,9801.47,11253.2,1451.73,"increase",21054.67,6527,2970,3557
"3328",1469,5120.94,5938.1,817.16,"increase",11059.04,3819,1867,1952
"3329",1988,4476.6,4494.93,18.3299999999999,"increase",8971.53,4815,2519,2296
"3330",282,7808.18,6939,-869.18,"increase",14747.18,4489,2405,2084
"3331",2140,5695.27,3480.2,-2215.07,"increase",9175.47,3091,1839,1252
"3332",268,478.34,253.15,-225.19,"increase",731.49,285,184,101
"3333",373,2413.18,2359.44,-53.7399999999998,"increase",4772.62,1182,543,639
"3334",417,0,70.85,70.85,"increase",70.85,16,0,16
"3335",524,12831.51,12199.08,-632.43,"increase",25030.59,6799,3508,3291
"3336",1704,5968.07,5661.86,-306.21,"increase",11629.93,4314,2207,2107
"3337",1985,5584.36,2144.68,-3439.68,"increase",7729.04,3280,2285,995
"3338",4737,2083.85,2873.13,789.28,"increase",4956.98,2518,1036,1482
"3339",4943,4728.49,2206.82,-2521.67,"increase",6935.31,2816,1845,971
"3340",449,0,6.95,6.95,"increase",6.95,4,0,4
"3341",1357,11280.81,10139.03,-1141.78,"increase",21419.84,5550,2973,2577
"3342",1388,3988.81,4198.76,209.95,"increase",8187.57,3398,1756,1642
"3343",1389,3988.81,4198.76,209.95,"increase",8187.57,3398,1756,1642
"3344",1623,8384.05,9969.05,1585,"increase",18353.1,7254,3304,3950
"3345",2144,3662.83,5641.54,1978.71,"increase",9304.37,3399,1214,2185
"3346",2981,4668.44,4666.23,-2.20999999999913,"increase",9334.67,4538,2255,2283
"3347",4863,0,2.49,2.49,"increase",2.49,3,0,3
"3348",150,192.64,0,-192.64,"increase",192.64,94,94,0
"3349",4800,3773.93,4219.95,446.02,"increase",7993.88,3788,1867,1921
"3350",4918,74.94,54.2,-20.74,"increase",129.14,25,10,15
"3351",4,13776.42,13719.07,-57.3500000000004,"increase",27495.49,7138,3646,3492
"3352",82,0,55.2,55.2,"increase",55.2,10,0,10
"3353",1354,7985.03,7792.88,-192.15,"increase",15777.91,6561,3265,3296
"3354",1628,3712.48,2974.57,-737.91,"increase",6687.05,1577,851,726
"3355",2803,3456.92,2826.54,-630.38,"increase",6283.46,2747,1498,1249
"3356",2843,3257.67,3275.95,18.2799999999997,"increase",6533.62,2752,1371,1381
"3357",2339,2401.75,2365.53,-36.2199999999998,"increase",4767.28,2241,1100,1141
"3358",1119,7.06,81.65,74.59,"increase",88.71,42,5,37
"3359",3319,3283.69,3075.66,-208.03,"increase",6359.35,2767,1429,1338
"3360",62,0,19.69,19.69,"increase",19.69,6,0,6
"3361",1519,11550.6,15777.48,4226.88,"increase",27328.08,8758,3643,5115
"3362",1526,2054.38,2795.93,741.55,"increase",4850.31,1446,656,790
"3363",2386,1240.09,1715.07,474.98,"increase",2955.16,1586,675,911
"3364",2766,4260.48,3643.62,-616.860000000001,"increase",7904.1,3526,1940,1586
"3365",3846,7768.06,9568.84,1800.78,"increase",17336.9,6961,3191,3770
"3366",551,7969.46,10014.71,2045.25,"increase",17984.17,5898,2755,3143
"3367",1041,6660.07,4895,-1765.07,"increase",11555.07,4153,2366,1787
"3368",1340,2257.38,2779.72,522.34,"increase",5037.1,2487,1143,1344
"3369",1842,5236.09,2287.41,-2948.68,"increase",7523.5,2668,1846,822
"3370",2638,4061.84,3394.42,-667.42,"increase",7456.26,2851,1543,1308
"3371",3752,3788.8,3268.92,-519.88,"increase",7057.72,2714,1487,1227
"3372",3936,3180.95,3873.46,692.51,"increase",7054.41,2270,1037,1233
"3373",4373,1898.43,1888.72,-9.71000000000004,"increase",3787.15,2424,1224,1200
"3374",115,2172.81,2565.4,392.59,"increase",4738.21,2097,965,1132
"3375",942,9173.28,9499.33,326.049999999999,"increase",18672.61,5735,2738,2997
"3376",2041,656.47,559.37,-97.1,"increase",1215.84,541,272,269
"3377",2785,3919.31,4317.48,398.17,"increase",8236.79,1646,771,875
"3378",414,959.27,142.37,-816.9,"increase",1101.64,403,343,60
"3379",725,4575.25,4082.52,-492.73,"increase",8657.77,3339,1777,1562
"3380",1839,2141.67,4923.92,2782.25,"increase",7065.59,2923,904,2019
"3381",2682,8672,8539.73,-132.27,"increase",17211.73,6169,3128,3041
"3382",4592,527.26,68.47,-458.79,"increase",595.73,255,222,33
"3383",625,4004.53,4138.91,134.38,"increase",8143.44,2861,1595,1266
"3384",1972,6470.88,6771.9,301.02,"increase",13242.78,5532,2750,2782
"3385",4229,11254.64,11270.06,15.4200000000001,"increase",22524.7,6400,3189,3211
"3386",517,298.6,18.27,-280.33,"increase",316.87,33,30,3
"3387",1474,2767.07,4686.17,1919.1,"increase",7453.24,2754,1001,1753
"3388",130,0,38.56,38.56,"increase",38.56,21,0,21
"3389",440,60.22,5.97,-54.25,"increase",66.19,32,28,4
"3390",2572,2010.22,2240.04,229.82,"increase",4250.26,1585,798,787
"3391",508,0,5.96,5.96,"increase",5.96,4,0,4
"3392",1996,3258.53,4209.66,951.13,"increase",7468.19,2668,1135,1533
"3393",3235,88.04,0,-88.04,"increase",88.04,22,22,0
"3394",4027,67.16,20.78,-46.38,"increase",87.94,20,18,2
"3395",285,20.48,2,-18.48,"increase",22.48,7,5,2
"3396",1403,1834.92,1655.26,-179.66,"increase",3490.18,1702,944,758
"3397",2813,4667.13,4910.91,243.78,"increase",9578.04,3441,1734,1707
"3398",137,10160.71,10374.97,214.259999999998,"increase",20535.68,7356,3581,3775
"3399",2465,0,17.78,17.78,"increase",17.78,3,0,3
"3400",4080,6174.51,6481.89,307.38,"increase",12656.4,4881,2359,2522
"3401",2536,9094.79,6721.07,-2373.72,"increase",15815.86,7146,3985,3161
"3402",2685,4912.06,3102.58,-1809.48,"increase",8014.64,3031,1774,1257
"3403",666,2587.92,3100.09,512.17,"increase",5688.01,3007,1418,1589
"3404",1017,12976.31,17680.76,4704.45,"increase",30657.07,12809,5638,7171
"3405",2754,4014.34,3693.91,-320.43,"increase",7708.25,3084,1543,1541
"3406",3589,79.66,0,-79.66,"increase",79.66,50,50,0
"3407",3666,1736.88,1177.01,-559.87,"increase",2913.89,1247,675,572
"3408",4157,6.59,0,-6.59,"increase",6.59,2,2,0
"3409",153,15.15,0,-15.15,"increase",15.15,7,7,0
"3410",195,0,31.08,31.08,"increase",31.08,10,0,10
"3411",4467,2245.04,3668.87,1423.83,"increase",5913.91,2712,1052,1660
"3412",4947,0,279.91,279.91,"increase",279.91,74,0,74
"3413",4485,4209.89,5342.66,1132.77,"increase",9552.55,3066,1422,1644
"3414",1202,8130.86,6603.24,-1527.62,"increase",14734.1,5192,2848,2344
"3415",514,3264.84,2960.66,-304.18,"increase",6225.5,4148,2138,2010
"3416",538,10920.98,9734.36,-1186.62,"increase",20655.34,7401,3741,3660
"3417",1626,9.53,0,-9.53,"increase",9.53,5,5,0
"3418",4426,4375.03,5899.31,1524.28,"increase",10274.34,4222,1830,2392
"3419",4428,4244.73,3754.53,-490.2,"increase",7999.26,3229,1723,1506
"3420",2760,5622.15,6448.93,826.780000000001,"increase",12071.08,5884,2800,3084
"3421",1700,0,1.98,1.98,"increase",1.98,2,0,2
"3422",3566,7400.51,6390.84,-1009.67,"increase",13791.35,6027,3314,2713
"3423",3937,10187.67,11486.17,1298.5,"increase",21673.84,8693,4091,4602
"3424",4511,9819.82,8819.74,-1000.08,"increase",18639.56,8661,4554,4107
"3425",383,11455.65,18439.07,6983.42,"increase",29894.72,11101,4502,6599
"3426",464,2.99,65.76,62.77,"increase",68.75,14,1,13
"3427",2279,2628.46,2072.21,-556.25,"increase",4700.67,2144,1298,846
"3428",2789,6694.67,7001.3,306.63,"increase",13695.97,4452,2101,2351
"3429",2451,0,43.63,43.63,"increase",43.63,38,0,38
"3430",1420,60.98,0,-60.98,"increase",60.98,5,5,0
"3431",3448,4925.84,188.27,-4737.57,"increase",5114.11,2048,2009,39
"3432",3901,3367.73,3851.07,483.34,"increase",7218.8,2453,1130,1323
"3433",1225,6393.8,6940.79,546.99,"increase",13334.59,5725,3080,2645
"3434",321,5595.71,5198.2,-397.51,"increase",10793.91,4443,2267,2176
"3435",2960,4788.45,4723.02,-65.4299999999994,"increase",9511.47,3677,1829,1848
"3436",4330,5506.32,4502.16,-1004.16,"increase",10008.48,3594,1949,1645
"3437",1259,4756.74,5404.14,647.400000000001,"increase",10160.88,4513,2122,2391
"3438",3838,2760.48,1848.55,-911.93,"increase",4609.03,1828,1010,818
"3439",976,3703.77,5941.84,2238.07,"increase",9645.61,4507,1962,2545
"3440",1696,1829.94,3249.72,1419.78,"increase",5079.66,2168,731,1437
"3441",2358,5.61,0,-5.61,"increase",5.61,1,1,0
"3442",1138,4165.3,4519.03,353.73,"increase",8684.33,3257,1593,1664
"3443",1911,7906.16,10087.16,2181,"increase",17993.32,6666,3112,3554
"3444",1120,6.44,0,-6.44,"increase",6.44,4,4,0
"3445",183,0,75.43,75.43,"increase",75.43,35,0,35
"3446",2017,5750.61,2928.98,-2821.63,"increase",8679.59,3085,2136,949
"3447",274,108.97,1243.17,1134.2,"increase",1352.14,398,15,383
"3448",572,2922.32,2479.83,-442.49,"increase",5402.15,2288,1122,1166
"3449",3877,878.35,1006.7,128.35,"increase",1885.05,1268,568,700
"3450",3342,6894.61,5677.2,-1217.41,"increase",12571.81,4766,2670,2096
"3451",194,3639.65,5122.51,1482.86,"increase",8762.16,3551,1511,2040
"3452",2067,5610.24,6451.37,841.13,"increase",12061.61,5638,2851,2787
"3453",1211,5610.99,5648.13,37.1400000000003,"increase",11259.12,5417,2745,2672
"3454",1359,2470.37,2735.38,265.01,"increase",5205.75,2931,1324,1607
"3455",1997,5244.85,4978.18,-266.67,"increase",10223.03,4586,2296,2290
"3456",1739,6009.32,6102.83,93.5100000000002,"increase",12112.15,4603,2320,2283
"3457",2310,8848.77,13064.08,4215.31,"increase",21912.85,7916,2832,5084
"3458",3853,8233.19,6997.45,-1235.74,"increase",15230.64,3790,2076,1714
"3459",4143,5684.49,7581.1,1896.61,"increase",13265.59,4567,1903,2664
"3460",2066,3544.49,4916.56,1372.07,"increase",8461.05,4478,1860,2618
"3461",2792,7172.82,5573.44,-1599.38,"increase",12746.26,4224,2334,1890
"3462",4098,5972.86,6300.75,327.89,"increase",12273.61,5685,2835,2850
"3463",4635,6987.96,10639.53,3651.57,"increase",17627.49,7211,2780,4431
"3464",1786,0,70.39,70.39,"increase",70.39,21,0,21
"3465",3717,2670.48,3306.48,636,"increase",5976.96,1753,766,987
"3466",1502,6659.42,4105.33,-2554.09,"increase",10764.75,4907,3055,1852
"3467",3000,2250.33,2557.16,306.83,"increase",4807.49,2358,1130,1228
"3468",1395,4224.77,3479.63,-745.14,"increase",7704.4,3252,1902,1350
"3469",3636,1863.32,2737.05,873.73,"increase",4600.37,1779,759,1020
"3470",4121,24.91,7.79,-17.12,"increase",32.7,15,9,6
"3471",4922,4.49,24.03,19.54,"increase",28.52,21,2,19
"3472",149,7.39,6.99,-0.399999999999999,"increase",14.38,7,2,5
"3473",1206,6004.76,8165.69,2160.93,"increase",14170.45,4774,2124,2650
"3474",2579,5497.01,6965.93,1468.92,"increase",12462.94,4086,1871,2215
"3475",3376,3556.62,0,-3556.62,"increase",3556.62,1302,1302,0
"3476",401,7038.11,7598,559.89,"increase",14636.11,4655,2341,2314
"3477",907,13068.99,13129,60.0100000000002,"increase",26197.99,7543,3811,3732
"3478",1484,0,38.47,38.47,"increase",38.47,18,0,18
"3479",3445,2638.05,3502.51,864.46,"increase",6140.56,1495,740,755
"3480",1358,33.77,92.51,58.74,"increase",126.28,31,12,19
"3481",2527,6658.54,9561.88,2903.34,"increase",16220.42,5334,2063,3271
"3482",4128,5073.65,4723.98,-349.669999999999,"increase",9797.63,3622,1872,1750
"3483",4712,1930.23,2113.68,183.45,"increase",4043.91,1846,1145,701
"3484",83,116.32,19.74,-96.58,"increase",136.06,43,35,8
"3485",311,549.37,76.24,-473.13,"increase",625.61,216,184,32
"3486",1200,2167.95,1867.45,-300.5,"increase",4035.4,1700,906,794
"3487",722,4019.73,4445.96,426.23,"increase",8465.69,3337,1675,1662
"3488",843,1159.53,1624.88,465.35,"increase",2784.41,1129,478,651
"3489",2196,1969.22,1261.35,-707.87,"increase",3230.57,1272,809,463
"3490",2298,2895.49,3347.87,452.38,"increase",6243.36,1763,781,982
"3491",2553,4864.59,2131.22,-2733.37,"increase",6995.81,2382,1654,728
"3492",2821,1481.49,1772.94,291.45,"increase",3254.43,1169,539,630
"3493",3231,19.85,42.75,22.9,"increase",62.6,22,11,11
"3494",941,2973.8,2147.4,-826.4,"increase",5121.2,1740,980,760
"3495",3087,2229.6,1904.71,-324.89,"increase",4134.31,1745,931,814
"3496",3721,3871.2,4070.35,199.15,"increase",7941.55,2680,1357,1323
"3497",3751,5688.03,4292.38,-1395.65,"increase",9980.41,2817,1704,1113
"3498",532,0,9.99,9.99,"increase",9.99,3,0,3
"3499",837,3245.74,3661.32,415.58,"increase",6907.06,2804,1315,1489
"3500",1471,99.36,0,-99.36,"increase",99.36,19,19,0
"3501",2694,21.26,0,-21.26,"increase",21.26,4,4,0
"3502",3380,3476.53,3195.94,-280.59,"increase",6672.47,2110,1119,991
"3503",19,2953.21,3739.91,786.7,"increase",6693.12,2777,1279,1498
"3504",212,803.59,566.46,-237.13,"increase",1370.05,466,257,209
"3505",240,72.97,0,-72.97,"increase",72.97,21,21,0
"3506",322,3359.36,2948.95,-410.41,"increase",6308.31,2343,1216,1127
"3507",452,57.72,10.86,-46.86,"increase",68.58,18,14,4
"3508",623,3105.16,3953.29,848.13,"increase",7058.45,2964,1254,1710
"3509",624,4004.67,4950.86,946.19,"increase",8955.53,3038,1376,1662
"3510",772,1724.53,2593.7,869.17,"increase",4318.23,1368,597,771
"3511",863,2870.61,2798.49,-72.1199999999999,"increase",5669.1,2583,1281,1302
"3512",1054,83.49,669.57,586.08,"increase",753.06,200,21,179
"3513",1203,3005.75,3435.09,429.34,"increase",6440.84,2580,1225,1355
"3514",1220,11437.41,11679.06,241.65,"increase",23116.47,10270,5372,4898
"3515",1382,5595.55,5465.21,-130.34,"increase",11060.76,4173,2154,2019
"3516",2042,3812.85,4288.01,475.16,"increase",8100.86,2603,1230,1373
"3517",2142,10433.94,9131.82,-1302.12,"increase",19565.76,6939,3857,3082
"3518",2242,4017.93,4469.92,451.99,"increase",8487.85,3480,1663,1817
"3519",2371,1837.3,2607.07,769.77,"increase",4444.37,1382,607,775
"3520",2617,5206.51,5042.3,-164.21,"increase",10248.81,2677,1415,1262
"3521",2764,4058.41,3839.1,-219.31,"increase",7897.51,2455,1309,1146
"3522",3085,2822.02,1455.94,-1366.08,"increase",4277.96,2005,1334,671
"3523",3192,2678.7,2793.93,115.23,"increase",5472.63,1740,835,905
"3524",3532,4349.77,4155.67,-194.1,"increase",8505.44,3455,1893,1562
"3525",4034,3592.34,3281.78,-310.56,"increase",6874.12,2172,1163,1009
"3526",4150,99.84,1.99,-97.85,"increase",101.83,30,29,1
"3527",4212,44.64,11.97,-32.67,"increase",56.61,23,20,3
"3528",4251,2118.95,1663.08,-455.87,"increase",3782.03,1232,695,537
"3529",76,0,41.29,41.29,"increase",41.29,11,0,11
"3530",2251,10789.87,10033.75,-756.120000000001,"increase",20823.62,6906,3593,3313
"3531",4857,2339.97,3939.78,1599.81,"increase",6279.75,3293,1210,2083
"3532",14,636.87,297.56,-339.31,"increase",934.43,335,245,90
"3533",162,12.97,21.02,8.05,"increase",33.99,12,7,5
"3534",498,2510.38,2871.91,361.53,"increase",5382.29,2695,1281,1414
"3535",763,5117.67,4357.4,-760.27,"increase",9475.07,4504,2473,2031
"3536",833,3001.17,2089.22,-911.95,"increase",5090.39,1763,1072,691
"3537",1323,3739.6,3972.27,232.67,"increase",7711.87,2741,1342,1399
"3538",1594,4659.67,5504.06,844.39,"increase",10163.73,3333,1560,1773
"3539",1655,4867.19,3871.91,-995.280000000001,"increase",8739.1,3398,1797,1601
"3540",1676,8970.04,9853.59,883.549999999999,"increase",18823.63,5696,2684,3012
"3541",2103,6958.76,9111.21,2152.45,"increase",16069.97,5382,2278,3104
"3542",2822,1859.48,0,-1859.48,"increase",1859.48,774,774,0
"3543",3408,2992.67,2896.66,-96.0100000000002,"increase",5889.33,2496,1270,1226
"3544",4005,6395,4968.5,-1426.5,"increase",11363.5,3991,2335,1656
"3545",4687,8536.53,6840.07,-1696.46,"increase",15376.6,3955,2120,1835
"3546",292,13.76,0,-13.76,"increase",13.76,8,8,0
"3547",729,2798.74,2749.63,-49.1100000000001,"increase",5548.37,2658,1364,1294
"3548",1122,17.66,0,-17.66,"increase",17.66,4,4,0
"3549",1722,6866.73,5340.32,-1526.41,"increase",12207.05,3540,1928,1612
"3550",1881,5617.92,4047.82,-1570.1,"increase",9665.74,3354,1907,1447
"3551",2078,17.32,0,-17.32,"increase",17.32,8,8,0
"3552",2123,352.44,58.41,-294.03,"increase",410.85,93,83,10
"3553",2308,67.09,0,-67.09,"increase",67.09,24,24,0
"3554",2431,0,63.61,63.61,"increase",63.61,11,0,11
"3555",2539,10884.32,25725.95,14841.63,"increase",36610.27,13764,4433,9331
"3556",3205,7113.47,8062.97,949.5,"increase",15176.44,4106,1948,2158
"3557",3320,7348.29,8007.71,659.42,"increase",15356,7104,3577,3527
"3558",3500,3363.43,3040.68,-322.75,"increase",6404.11,2117,1101,1016
"3559",3768,6790.79,6985.84,195.05,"increase",13776.63,4631,2328,2303
"3560",3871,43.36,0,-43.36,"increase",43.36,32,32,0
"3561",4185,9.85,0,-9.85,"increase",9.85,5,5,0
"3562",4216,10589.48,11797.71,1208.23,"increase",22387.19,9294,4767,4527
"3563",72,7053.18,7941.85,888.67,"increase",14995.03,4634,2224,2410
"3564",185,6583.48,4497.09,-2086.39,"increase",11080.57,4242,2436,1806
"3565",1470,10353.95,9260.39,-1093.56,"increase",19614.34,5642,3024,2618
"3566",2120,3443.48,3099.16,-344.32,"increase",6542.64,2971,1590,1381
"3567",3114,9181.78,8816.07,-365.710000000001,"increase",17997.85,5556,2661,2895
"3568",3266,0,13.22,13.22,"increase",13.22,6,0,6
"3569",3344,2452.56,1730.08,-722.48,"increase",4182.64,1174,705,469
"3570",4141,5358.2,5691.78,333.58,"increase",11049.98,3503,1745,1758
"3571",4164,2946.75,3194.36,247.61,"increase",6141.11,2510,1163,1347
"3572",4205,3285.27,4781.12,1495.85,"increase",8066.39,3156,1281,1875
"3573",4831,996.24,52.79,-943.45,"increase",1049.03,446,420,26
"3574",260,0,165.4,165.4,"increase",165.4,49,0,49
"3575",1810,0,62.93,62.93,"increase",62.93,23,0,23
"3576",2414,11.88,0,-11.88,"increase",11.88,5,5,0
"3577",3007,3139.47,4226.14,1086.67,"increase",7365.61,2066,745,1321
"3578",3238,14.46,0,-14.46,"increase",14.46,2,2,0
"3579",4056,3457.49,3671.37,213.88,"increase",7128.86,2361,1086,1275
"3580",4300,44.75,0,-44.75,"increase",44.75,12,12,0
"3581",4362,4090.33,6018.19,1927.86,"increase",10108.52,3987,1452,2535
"3582",4512,3898.47,4369.51,471.04,"increase",8267.98,3122,1489,1633
"3583",4828,51.77,1.67,-50.1,"increase",53.44,13,12,1
"3584",428,3916.98,4495.62,578.64,"increase",8412.6,2249,1007,1242
"3585",747,2303.66,2529.29,225.63,"increase",4832.95,2265,1051,1214
"3586",3123,3030.26,6693.78,3663.52,"increase",9724.04,3248,1060,2188
"3587",3676,4456.32,4604.74,148.42,"increase",9061.06,4010,1950,2060
"3588",4773,2041.04,1780.26,-260.78,"increase",3821.3,1606,908,698
"3589",470,77.16,10.83,-66.33,"increase",87.99,16,13,3
"3590",1895,4245.89,2602.73,-1643.16,"increase",6848.62,2111,1329,782
"3591",3272,49.15,0,-49.15,"increase",49.15,10,10,0
"3592",530,400.62,142.42,-258.2,"increase",543.04,129,102,27
"3593",783,2354,2842.43,488.43,"increase",5196.43,1416,649,767
"3594",928,6755.87,6200.84,-555.03,"increase",12956.71,4192,2224,1968
"3595",987,5964.34,4891.84,-1072.5,"increase",10856.18,3356,1800,1556
"3596",1007,12849.18,12541.48,-307.700000000001,"increase",25390.66,8003,4045,3958
"3597",1329,7969.85,8575.81,605.959999999999,"increase",16545.66,5402,2748,2654
"3598",1381,7985.77,9315.67,1329.9,"increase",17301.44,5901,2550,3351
"3599",1405,4090.96,4213.83,122.87,"increase",8304.79,3288,1724,1564
"3600",1816,2868.79,1380.62,-1488.17,"increase",4249.41,1142,785,357
"3601",1848,4279.48,5562.24,1282.76,"increase",9841.72,3237,1425,1812
"3602",2229,6562.8,6182.2,-380.6,"increase",12745,5330,2777,2553
"3603",2248,120.06,52.32,-67.74,"increase",172.38,64,46,18
"3604",2403,64.61,161.51,96.9,"increase",226.12,63,14,49
"3605",2717,6555.04,5451.44,-1103.6,"increase",12006.48,5575,2959,2616
"3606",2740,3708.39,4847.73,1139.34,"increase",8556.12,3541,1625,1916
"3607",2930,6786.77,7707.21,920.44,"increase",14493.98,6494,2964,3530
"3608",3338,4677.52,5373.79,696.27,"increase",10051.31,3031,1465,1566
"3609",3680,0,23.68,23.68,"increase",23.68,8,0,8
"3610",3753,3302.39,3085.31,-217.08,"increase",6387.7,2068,1019,1049
"3611",4217,59.5,4636.53,4577.03,"increase",4696.03,1415,27,1388
"3612",4705,5.88,0,-5.88,"increase",5.88,2,2,0
"3613",184,6.48,4.99,-1.49,"increase",11.47,4,3,1
"3614",246,0,16.99,16.99,"increase",16.99,1,0,1
"3615",273,17.83,4.77,-13.06,"increase",22.6,10,7,3
"3616",328,23.47,9.48,-13.99,"increase",32.95,5,3,2
"3617",552,5035.89,1069.24,-3966.65,"increase",6105.13,2287,1967,320
"3618",640,3164.72,3159.87,-4.85000000000036,"increase",6324.59,2272,1179,1093
"3619",811,5099.29,5473.23,373.940000000001,"increase",10572.52,2952,1447,1505
"3620",937,16047.49,17706.61,1659.12,"increase",33754.1,12131,5456,6675
"3621",1168,9966.17,11233.78,1267.61,"increase",21199.95,7895,3625,4270
"3622",1184,0,19.87,19.87,"increase",19.87,4,0,4
"3623",1236,7947.51,8192.47,244.959999999999,"increase",16139.98,6285,3118,3167
"3624",1284,1241.06,2157.96,916.9,"increase",3399.02,1103,437,666
"3625",1423,3494.03,4969.37,1475.34,"increase",8463.4,4038,1823,2215
"3626",1653,3086.78,3171.23,84.4499999999998,"increase",6258.01,2935,1435,1500
"3627",1689,7107.67,6754.37,-353.3,"increase",13862.04,3886,1982,1904
"3628",1806,2339.87,807.58,-1532.29,"increase",3147.45,960,679,281
"3629",2018,11987.14,13950.44,1963.3,"increase",25937.58,11122,5111,6011
"3630",2141,1889.22,2518.17,628.95,"increase",4407.39,1741,637,1104
"3631",2239,14808.14,10621.62,-4186.52,"increase",25429.76,10531,5943,4588
"3632",2273,10129.13,9847.94,-281.189999999999,"increase",19977.07,5162,2608,2554
"3633",2456,8843.5,10336.31,1492.81,"increase",19179.81,6663,3134,3529
"3634",2876,3430.25,3359.42,-70.8299999999999,"increase",6789.67,2266,1208,1058
"3635",3105,6676.73,6569.31,-107.42,"increase",13246.04,4494,2276,2218
"3636",3135,5655.9,4388.03,-1267.87,"increase",10043.93,4259,2484,1775
"3637",3212,11.99,0,-11.99,"increase",11.99,2,2,0
"3638",3659,5500.6,6789.24,1288.64,"increase",12289.84,4147,1828,2319
"3639",3954,4158.38,4257.06,98.6800000000003,"increase",8415.44,3337,1616,1721
"3640",4051,13621.26,12073.6,-1547.66,"increase",25694.86,9548,5187,4361
"3641",4417,7960.74,7395.16,-565.58,"increase",15355.9,4683,2356,2327
"3642",4534,6276.17,3945.74,-2330.43,"increase",10221.91,3484,2189,1295
"3643",4544,4772.89,6041.07,1268.18,"increase",10813.96,3276,1522,1754
"3644",4782,3249.87,3212.09,-37.7799999999997,"increase",6461.96,3010,1546,1464
"3645",4820,12701.17,14096.4,1395.23,"increase",26797.57,9078,4214,4864
"3646",4902,2852.31,3833.26,980.95,"increase",6685.57,1408,562,846
"3647",459,17.22,0,-17.22,"increase",17.22,5,5,0
"3648",507,5678.57,4979.67,-698.9,"increase",10658.24,4050,2130,1920
"3649",639,1378.66,1093.63,-285.03,"increase",2472.29,961,528,433
"3650",751,4107.91,1790.52,-2317.39,"increase",5898.43,1825,1302,523
"3651",932,6912.54,4354.31,-2558.23,"increase",11266.85,4147,2633,1514
"3652",1209,6619.82,5525.78,-1094.04,"increase",12145.6,4288,2328,1960
"3653",1431,47.87,27.06,-20.81,"increase",74.93,26,13,13
"3654",1481,2951.82,2869.47,-82.3499999999999,"increase",5821.29,2787,1434,1353
"3655",1548,0,43.59,43.59,"increase",43.59,26,0,26
"3656",1650,3983.87,4178.01,194.14,"increase",8161.88,3977,1859,2118
"3657",1926,0,3.59,3.59,"increase",3.59,3,0,3
"3658",3187,2744.48,3012.24,267.76,"increase",5756.72,1978,913,1065
"3659",3289,13555.42,12192.04,-1363.38,"increase",25747.46,7193,3834,3359
"3660",3514,3447.55,2077.34,-1370.21,"increase",5524.89,2456,1448,1008
"3661",3567,6914.81,2356.08,-4558.73,"increase",9270.89,3062,2323,739
"3662",3769,12.46,0,-12.46,"increase",12.46,5,5,0
"3663",3964,4037.33,1040.31,-2997.02,"increase",5077.64,1866,1532,334
"3664",3966,6113.28,7899.92,1786.64,"increase",14013.2,4646,2094,2552
"3665",4449,6880.55,5734.84,-1145.71,"increase",12615.39,4454,2498,1956
"3666",4492,3961.42,3066.89,-894.53,"increase",7028.31,2552,1392,1160
"3667",4809,13.15,0,-13.15,"increase",13.15,3,3,0
"3668",163,0,66.62,66.62,"increase",66.62,16,0,16
"3669",173,0,19.75,19.75,"increase",19.75,5,0,5
"3670",576,4466.99,3965.1,-501.89,"increase",8432.09,2583,1416,1167
"3671",626,3086.65,903.33,-2183.32,"increase",3989.98,1503,1199,304
"3672",709,5186.29,4992.95,-193.34,"increase",10179.24,2844,1344,1500
"3673",1072,4.53,0,-4.53,"increase",4.53,4,4,0
"3674",1217,8673.18,8688.58,15.3999999999996,"increase",17361.76,5239,2611,2628
"3675",1239,7566.14,10613.4,3047.26,"increase",18179.54,6134,2557,3577
"3676",1384,13415.1,15977.46,2562.36,"increase",29392.56,8736,3974,4762
"3677",1862,52.51,127.24,74.73,"increase",179.75,50,18,32
"3678",1864,0,3.29,3.29,"increase",3.29,1,0,1
"3679",1940,4283.93,4486.21,202.28,"increase",8770.14,3481,1691,1790
"3680",1944,7858.41,8807.37,948.960000000001,"increase",16665.78,6406,3056,3350
"3681",2100,0,303.68,303.68,"increase",303.68,71,0,71
"3682",2195,11875.72,11669.42,-206.299999999999,"increase",23545.14,7212,3353,3859
"3683",2474,87.11,0,-87.11,"increase",87.11,23,23,0
"3684",2574,65.94,0,-65.94,"increase",65.94,20,20,0
"3685",2746,6733.98,5902.62,-831.360000000001,"increase",12636.6,4740,2487,2253
"3686",2955,5080.65,6434.85,1354.2,"increase",11515.5,4143,1827,2316
"3687",3425,6104.17,6712.91,608.74,"increase",12817.08,4491,2129,2362
"3688",3476,6545.9,5234.99,-1310.91,"increase",11780.89,4293,2429,1864
"3689",3652,4710.54,6396.52,1685.98,"increase",11107.06,3538,1526,2012
"3690",4071,6.67,24.77,18.1,"increase",31.44,6,3,3
"3691",4490,4922.47,4509.18,-413.29,"increase",9431.65,3954,1970,1984
"3692",543,3366.21,3860.4,494.19,"increase",7226.61,3290,1362,1928
"3693",827,4897.38,5163.25,265.87,"increase",10060.63,3413,1825,1588
"3694",898,3923.54,4653.1,729.56,"increase",8576.64,2686,1157,1529
"3695",1035,2202.71,2013.55,-189.16,"increase",4216.26,1864,1021,843
"3696",1538,4063.97,4097.79,33.8199999999997,"increase",8161.76,4576,2257,2319
"3697",2220,3278.72,5439.51,2160.79,"increase",8718.23,3922,1733,2189
"3698",3099,7290.71,7863.31,572.6,"increase",15154.02,5642,2482,3160
"3699",3724,7989.58,7418.42,-571.16,"increase",15408,6057,3125,2932
"3700",4024,4638.43,5659.37,1020.94,"increase",10297.8,4112,1829,2283
"3701",4175,6733.14,8205.08,1471.94,"increase",14938.22,6804,3328,3476
"3702",4394,5070.15,5039.8,-30.3499999999995,"increase",10109.95,3261,1757,1504
"3703",4839,6049.31,5220.64,-828.67,"increase",11269.95,4417,2412,2005
"3704",69,0,52.47,52.47,"increase",52.47,11,0,11
"3705",390,44.82,50.66,5.84,"increase",95.48,21,9,12
"3706",410,54.21,78.51,24.3,"increase",132.72,35,19,16
"3707",465,310.12,285.08,-25.04,"increase",595.2,179,96,83
"3708",497,4915.8,5268.78,352.98,"increase",10184.58,2751,1339,1412
"3709",622,9847.98,8656.79,-1191.19,"increase",18504.77,6307,3232,3075
"3710",981,6883.57,5576.72,-1306.85,"increase",12460.29,3493,1930,1563
"3711",1040,10540.26,11902.88,1362.62,"increase",22443.14,6992,3322,3670
"3712",1068,185.02,0,-185.02,"increase",185.02,71,71,0
"3713",1727,29.42,180.01,150.59,"increase",209.43,51,10,41
"3714",2145,3120.68,2655.82,-464.86,"increase",5776.5,1307,731,576
"3715",2337,7938.77,15361.67,7422.9,"increase",23300.44,6479,2285,4194
"3716",2415,5,0,-5,"increase",5,5,5,0
"3717",2420,0,278.15,278.15,"increase",278.15,93,0,93
"3718",3052,0,7.99,7.99,"increase",7.99,1,0,1
"3719",3115,7820.65,6648.92,-1171.73,"increase",14469.57,4071,2190,1881
"3720",3136,29.82,0,-29.82,"increase",29.82,13,13,0
"3721",3328,6344.37,10699.71,4355.34,"increase",17044.08,4695,1607,3088
"3722",3364,4411.79,3906.97,-504.82,"increase",8318.76,1799,896,903
"3723",3628,5061.58,5703.4,641.82,"increase",10764.98,3128,1491,1637
"3724",3634,9588.66,9647.39,58.7299999999996,"increase",19236.05,5653,2939,2714
"3725",3733,6118.44,7720.35,1601.91,"increase",13838.79,4655,2018,2637
"3726",3943,7008.71,8812.62,1803.91,"increase",15821.33,5622,2686,2936
"3727",3984,0,572.43,572.43,"increase",572.43,156,0,156
"3728",4002,3892.95,3106.19,-786.76,"increase",6999.14,2101,1219,882
"3729",4042,4.16,77.11,72.95,"increase",81.27,16,2,14
"3730",4131,19.39,22.43,3.04,"increase",41.82,18,10,8
"3731",4308,2951.92,2296.39,-655.53,"increase",5248.31,2092,1183,909
"3732",4661,4538.15,4582.17,44.0200000000004,"increase",9120.32,2646,1368,1278
"3733",4766,313.01,369.03,56.02,"increase",682.04,232,103,129
"3734",5,7358.62,7646.96,288.34,"increase",15005.58,5222,2672,2550
"3735",47,4443.91,3125.49,-1318.42,"increase",7569.4,3319,2041,1278
"3736",151,631.15,269.61,-361.54,"increase",900.76,239,145,94
"3737",224,8458.57,8519.91,61.3400000000001,"increase",16978.48,5548,2796,2752
"3738",229,3262.12,4012.29,750.17,"increase",7274.41,2080,1036,1044
"3739",307,79.95,209.88,129.93,"increase",289.83,56,10,46
"3740",344,2979.85,4048.68,1068.83,"increase",7028.53,2743,1186,1557
"3741",372,4918.04,5733.88,815.84,"increase",10651.92,3796,1812,1984
"3742",427,3.99,0,-3.99,"increase",3.99,1,1,0
"3743",510,6553.31,6449.48,-103.83,"increase",13002.79,5622,2866,2756
"3744",579,2481.95,3218.81,736.86,"increase",5700.76,1983,947,1036
"3745",700,8092.43,4447.12,-3645.31,"increase",12539.55,5378,3439,1939
"3746",842,3027.63,3937.6,909.97,"increase",6965.23,3181,1408,1773
"3747",1232,3593.05,4012.74,419.69,"increase",7605.79,3104,1502,1602
"3748",1245,3493.08,1647.29,-1845.79,"increase",5140.37,2618,1626,992
"3749",1537,14176.73,13471.65,-705.08,"increase",27648.38,8189,4193,3996
"3750",1625,2351.51,3079.82,728.31,"increase",5431.33,2115,885,1230
"3751",1753,30.89,87.17,56.28,"increase",118.06,38,10,28
"3752",2068,2538.47,1856.56,-681.91,"increase",4395.03,1311,758,553
"3753",2271,60.69,86.02,25.33,"increase",146.71,72,24,48
"3754",2316,0,21.06,21.06,"increase",21.06,8,0,8
"3755",2478,2322.23,2599.11,276.88,"increase",4921.34,1670,793,877
"3756",2655,5784.1,4813.58,-970.52,"increase",10597.68,3414,1728,1686
"3757",2666,3364.85,5270.8,1905.95,"increase",8635.65,3700,1446,2254
"3758",2727,3906.47,3373.35,-533.12,"increase",7279.82,4023,2070,1953
"3759",2749,5684.19,7225.37,1541.18,"increase",12909.56,4917,2291,2626
"3760",2758,3607.72,4143.69,535.97,"increase",7751.41,2438,1231,1207
"3761",2985,2408.68,1322.73,-1085.95,"increase",3731.41,1087,703,384
"3762",2989,4287.95,2084.75,-2203.2,"increase",6372.7,2774,1748,1026
"3763",3223,13.99,0,-13.99,"increase",13.99,1,1,0
"3764",3296,3555.82,2969.46,-586.36,"increase",6525.28,2966,1666,1300
"3765",3436,3619,2727.16,-891.84,"increase",6346.16,1886,1060,826
"3766",3633,3169.66,2810.43,-359.23,"increase",5980.09,3358,1755,1603
"3767",3785,46.68,34.5,-12.18,"increase",81.18,27,17,10
"3768",3820,6522.53,6755.53,233,"increase",13278.06,4842,2360,2482
"3769",3911,2679.14,2198.17,-480.97,"increase",4877.31,1967,1085,882
"3770",3999,9268.36,14714.39,5446.03,"increase",23982.75,10483,4359,6124
"3771",4003,4425.65,4587.49,161.84,"increase",9013.14,2504,1235,1269
"3772",4082,5675.53,5190.4,-485.13,"increase",10865.93,3550,1804,1746
"3773",4101,286.75,13.99,-272.76,"increase",300.74,119,116,3
"3774",4571,7982.68,5584.84,-2397.84,"increase",13567.52,5471,3280,2191
"3775",4679,0,24.27,24.27,"increase",24.27,9,0,9
"3776",4768,6738.4,7094.22,355.82,"increase",13832.62,4727,2206,2521
"3777",4774,2600.94,2209.98,-390.96,"increase",4810.92,1520,829,691
"3778",4798,4952.79,2572.39,-2380.4,"increase",7525.18,2357,1661,696
"3779",55,5046.14,5394.28,348.139999999999,"increase",10440.42,3268,1572,1696
"3780",64,2.29,0,-2.29,"increase",2.29,1,1,0
"3781",199,104.54,0,-104.54,"increase",104.54,39,39,0
"3782",247,172.97,0,-172.97,"increase",172.97,98,98,0
"3783",349,8983.04,8167.57,-815.470000000001,"increase",17150.61,7318,3869,3449
"3784",583,6302.64,6979.34,676.7,"increase",13281.98,3651,1772,1879
"3785",642,17.93,0,-17.93,"increase",17.93,7,7,0
"3786",892,3273.2,3438.26,165.06,"increase",6711.46,2834,1408,1426
"3787",948,554.43,314.91,-239.52,"increase",869.34,302,197,105
"3788",997,10757.18,11147.49,390.309999999999,"increase",21904.67,8827,4480,4347
"3789",1111,0,20.74,20.74,"increase",20.74,7,0,7
"3790",1197,6952.56,6952.73,0.170000000000073,"increase",13905.29,5201,2622,2579
"3791",1418,7896.64,7621.06,-275.58,"increase",15517.7,3915,2021,1894
"3792",1453,4298.6,5124.86,826.259999999999,"increase",9423.46,2766,1290,1476
"3793",1912,10731.57,9305.35,-1426.22,"increase",20036.92,6375,3411,2964
"3794",2043,1601.9,1856.35,254.45,"increase",3458.25,748,358,390
"3795",2143,4882.81,9332.56,4449.75,"increase",14215.37,4988,1455,3533
"3796",2158,1753.89,3907.48,2153.59,"increase",5661.37,2136,633,1503
"3797",2193,105.07,0,-105.07,"increase",105.07,8,8,0
"3798",2570,3286.16,3812.84,526.68,"increase",7099,3828,1936,1892
"3799",2593,4831.76,6146.31,1314.55,"increase",10978.07,3419,1529,1890
"3800",2686,3834.39,4253.51,419.12,"increase",8087.9,2602,1229,1373
"3801",2771,7298.82,8619.09,1320.27,"increase",15917.91,4213,1890,2323
"3802",2865,2298.88,2648.73,349.85,"increase",4947.61,1917,920,997
"3803",2907,3516.72,2230.98,-1285.74,"increase",5747.7,2247,1352,895
"3804",2912,5537.22,3140.19,-2397.03,"increase",8677.41,2578,1604,974
"3805",3063,2629.59,1909.09,-720.5,"increase",4538.68,1950,1180,770
"3806",3198,6211.66,5822.46,-389.2,"increase",12034.12,4499,2136,2363
"3807",3255,8726.62,8409.97,-316.650000000001,"increase",17136.59,5244,2653,2591
"3808",3277,7.48,0,-7.48,"increase",7.48,2,2,0
"3809",3496,5108.63,4129.98,-978.65,"increase",9238.61,3702,2015,1687
"3810",3732,7897.31,3264.48,-4632.83,"increase",11161.79,3565,2419,1146
"3811",3737,6842.86,6028.75,-814.11,"increase",12871.61,3686,2098,1588
"3812",3805,2672.7,2074.96,-597.74,"increase",4747.66,1615,912,703
"3813",3935,2219.38,1366.38,-853,"increase",3585.76,1458,936,522
"3814",3974,310.58,295.34,-15.24,"increase",605.92,188,108,80
"3815",4030,2990.23,3989.63,999.4,"increase",6979.86,2820,1177,1643
"3816",4104,209.78,0,-209.78,"increase",209.78,78,78,0
"3817",4123,5063.11,6158.06,1094.95,"increase",11221.17,3601,1763,1838
"3818",4187,9025.68,7859.29,-1166.39,"increase",16884.97,4939,2600,2339
"3819",4260,5011.74,2879.87,-2131.87,"increase",7891.61,2986,1853,1133
"3820",4631,4006.36,3690.14,-316.22,"increase",7696.5,3533,1787,1746
"3821",4901,25.98,0,-25.98,"increase",25.98,2,2,0
"3822",15,53.36,0,-53.36,"increase",53.36,31,31,0
"3823",56,6.88,3.85,-3.03,"increase",10.73,6,3,3
"3824",97,25.98,24.8,-1.18,"increase",50.78,13,2,11
"3825",362,0,625.2,625.2,"increase",625.2,218,0,218
"3826",404,1127.05,1168.19,41.1400000000001,"increase",2295.24,542,245,297
"3827",636,985.34,49.37,-935.97,"increase",1034.71,505,490,15
"3828",668,7837.81,7617.71,-220.1,"increase",15455.52,6061,3114,2947
"3829",860,2331.89,2581.35,249.46,"increase",4913.24,1467,751,716
"3830",961,2869.63,3487.07,617.44,"increase",6356.7,2122,1024,1098
"3831",1113,11.53,116.09,104.56,"increase",127.62,61,6,55
"3832",1370,4872.29,5400.46,528.17,"increase",10272.75,3449,1657,1792
"3833",1542,0,3.56,3.56,"increase",3.56,4,0,4
"3834",1562,0,33.35,33.35,"increase",33.35,12,0,12
"3835",2071,6430.55,6754.28,323.73,"increase",13184.83,3657,1879,1778
"3836",2122,1447.77,1803.32,355.55,"increase",3251.09,1069,496,573
"3837",2223,11353.45,13763.83,2410.38,"increase",25117.28,6549,2944,3605
"3838",2518,4883.04,5387.44,504.400000000001,"increase",10270.48,3871,1899,1972
"3839",2547,7962.83,7469.37,-493.46,"increase",15432.2,4798,2462,2336
"3840",2584,3551.5,3814.25,262.75,"increase",7365.75,2937,1495,1442
"3841",2651,2147.96,1977.54,-170.42,"increase",4125.5,2154,1119,1035
"3842",2788,8611.7,9456.38,844.68,"increase",18068.08,5395,2609,2786
"3843",3045,12410.31,15520.93,3110.62,"increase",27931.24,8349,3880,4469
"3844",3150,6398.21,6175.02,-223.19,"increase",12573.23,3776,1985,1791
"3845",3324,8346.92,6061.78,-2285.14,"increase",14408.7,4070,2409,1661
"3846",3489,6416.07,7098.68,682.610000000001,"increase",13514.75,4991,2477,2514
"3847",3521,2538.13,1544.92,-993.21,"increase",4083.05,1317,820,497
"3848",3625,5472.35,4461.15,-1011.2,"increase",9933.5,3204,1768,1436
"3849",3679,6739.68,7166.19,426.51,"increase",13905.87,4946,2528,2418
"3850",3690,34.67,149.75,115.08,"increase",184.42,74,8,66
"3851",3748,6047.58,3843.28,-2204.3,"increase",9890.86,3487,2145,1342
"3852",3922,9215.94,9017.39,-198.550000000001,"increase",18233.33,5421,2738,2683
"3853",4079,4679.61,3671.73,-1007.88,"increase",8351.34,2613,1526,1087
"3854",4237,3438.54,5608.73,2170.19,"increase",9047.27,4656,1805,2851
"3855",4503,61.31,8.62,-52.69,"increase",69.93,27,21,6
"3856",4626,28.97,7.97,-21,"increase",36.94,6,3,3
"3857",4653,6125.51,5546.39,-579.12,"increase",11671.9,4158,2205,1953
"3858",4700,2141.96,2142.3,0.340000000000146,"increase",4284.26,918,518,400
"3859",187,9253.48,10077.12,823.640000000001,"increase",19330.6,4845,2470,2375
"3860",190,12784.85,9540.39,-3244.46,"increase",22325.24,6520,3982,2538
"3861",228,0,45.36,45.36,"increase",45.36,18,0,18
"3862",248,5.78,0,-5.78,"increase",5.78,2,2,0
"3863",519,3699.21,4409.72,710.51,"increase",8108.93,2915,1269,1646
"3864",521,1442.74,1019.59,-423.15,"increase",2462.33,1355,813,542
"3865",599,6145.24,8213.87,2068.63,"increase",14359.11,4898,2159,2739
"3866",821,2084.67,2942.95,858.28,"increase",5027.62,2013,861,1152
"3867",834,2658.57,1700.49,-958.08,"increase",4359.06,1320,786,534
"3868",1124,0,37.47,37.47,"increase",37.47,20,0,20
"3869",1127,74.59,19.99,-54.6,"increase",94.58,41,33,8
"3870",1134,0,308.86,308.86,"increase",308.86,97,0,97
"3871",1164,7430.17,6357.43,-1072.74,"increase",13787.6,4154,2328,1826
"3872",1331,3317.41,4003.24,685.83,"increase",7320.65,2670,1292,1378
"3873",1401,6764.06,6434.44,-329.620000000001,"increase",13198.5,5354,2708,2646
"3874",1738,11043.86,9180.17,-1863.69,"increase",20224.03,5620,2948,2672
"3875",1889,1818.75,2927.96,1109.21,"increase",4746.71,1614,621,993
"3876",2127,6972.44,8881.83,1909.39,"increase",15854.27,5350,2559,2791
"3877",2131,5253.75,4475.29,-778.46,"increase",9729.04,4628,2310,2318
"3878",2450,58.96,0,-58.96,"increase",58.96,9,9,0
"3879",2462,0,40.2,40.2,"increase",40.2,10,0,10
"3880",2600,5083.7,4600.03,-483.67,"increase",9683.73,2647,1290,1357
"3881",2644,8197.22,6710.52,-1486.7,"increase",14907.74,3727,1981,1746
"3882",2775,29154.17,27270.2,-1883.97,"increase",56424.37,14721,7963,6758
"3883",2871,4706.56,5183.63,477.07,"increase",9890.19,3028,1435,1593
"3884",2949,7428.54,6206.45,-1222.09,"increase",13634.99,4751,2543,2208
"3885",3183,5173.56,5302.97,129.41,"increase",10476.53,3492,1680,1812
"3886",3249,0,1270.76,1270.76,"increase",1270.76,592,0,592
"3887",3684,48.25,1.69,-46.56,"increase",49.94,9,7,2
"3888",3861,0,47.23,47.23,"increase",47.23,19,0,19
"3889",3987,7563.64,8331.79,768.150000000001,"increase",15895.43,5778,2737,3041
"3890",4106,20.47,9.93,-10.54,"increase",30.4,7,4,3
"3891",225,33.1,0,-33.1,"increase",33.1,17,17,0
"3892",411,12.92,0,-12.92,"increase",12.92,5,5,0
"3893",595,3449.97,4656.87,1206.9,"increase",8106.84,2599,1122,1477
"3894",627,1100.71,2040.81,940.1,"increase",3141.52,1062,352,710
"3895",675,2133.44,1483.74,-649.7,"increase",3617.18,1593,918,675
"3896",682,7790.16,7909.84,119.68,"increase",15700,4844,2472,2372
"3897",743,3715.12,2997.61,-717.51,"increase",6712.73,4092,2158,1934
"3898",806,2527.34,2917.78,390.44,"increase",5445.12,2498,1208,1290
"3899",871,1952.8,1525.85,-426.95,"increase",3478.65,2152,1143,1009
"3900",956,4789.71,3819.56,-970.15,"increase",8609.27,2608,1442,1166
"3901",974,2378.28,2661.53,283.25,"increase",5039.81,1385,632,753
"3902",1433,1107.16,1141.91,34.75,"increase",2249.07,876,436,440
"3903",1636,3811.08,2631.16,-1179.92,"increase",6442.24,2159,1300,859
"3904",2170,8895.68,8684.76,-210.92,"increase",17580.44,5405,2703,2702
"3905",2249,3367.32,2580.88,-786.44,"increase",5948.2,2623,1456,1167
"3906",3164,6937.5,5781.93,-1155.57,"increase",12719.43,3707,1927,1780
"3907",3716,0,5,5,"increase",5,4,0,4
"3908",4126,5006.79,2414.29,-2592.5,"increase",7421.08,3331,2216,1115
"3909",4292,3237.86,3471.43,233.57,"increase",6709.29,3319,1622,1697
"3910",4488,884.5,2029,1144.5,"increase",2913.5,975,290,685
"3911",1,1990.61,2123.33,132.72,"increase",4113.94,1782,843,939
"3912",220,24.98,0,-24.98,"increase",24.98,6,6,0
"3913",381,296.41,174.62,-121.79,"increase",471.03,148,99,49
"3914",433,3,0,-3,"increase",3,2,2,0
"3915",755,6454.74,6813.28,358.54,"increase",13268.02,3836,1965,1871
"3916",1012,9847.72,9362.33,-485.389999999999,"increase",19210.05,5331,2694,2637
"3917",1187,9020.74,9217.73,196.99,"increase",18238.47,5014,2544,2470
"3918",1212,7599.02,8064.99,465.969999999999,"increase",15664.01,4618,2297,2321
"3919",1297,0,3.79,3.79,"increase",3.79,3,0,3
"3920",1404,7662.44,7967.52,305.08,"increase",15629.96,5259,2646,2613
"3921",1454,6289.34,8068.69,1779.35,"increase",14358.03,4800,2187,2613
"3922",1661,2234.36,3723.3,1488.94,"increase",5957.66,2053,614,1439
"3923",1692,92.02,0,-92.02,"increase",92.02,30,30,0
"3924",1721,23.15,0,-23.15,"increase",23.15,9,9,0
"3925",1742,4.79,0,-4.79,"increase",4.79,1,1,0
"3926",1802,0,54.53,54.53,"increase",54.53,22,0,22
"3927",2165,257.58,172.02,-85.56,"increase",429.6,77,42,35
"3928",2187,2530.83,2635.51,104.68,"increase",5166.34,1435,666,769
"3929",2207,7799.53,10039.02,2239.49,"increase",17838.55,5273,2319,2954
"3930",2417,0,254.15,254.15,"increase",254.15,78,0,78
"3931",2430,7388.47,6914.64,-473.83,"increase",14303.11,4763,2544,2219
"3932",2490,104.39,0,-104.39,"increase",104.39,35,35,0
"3933",2722,2574.77,1861.63,-713.14,"increase",4436.4,1581,920,661
"3934",2784,6534.61,3102.71,-3431.9,"increase",9637.32,1736,1151,585
"3935",2805,4192.76,4994.83,802.07,"increase",9187.59,2386,1117,1269
"3936",2897,1912.37,1205.84,-706.53,"increase",3118.21,860,513,347
"3937",2945,23.26,0,-23.26,"increase",23.26,6,6,0
"3938",3014,11242.49,11717.95,475.460000000001,"increase",22960.44,7786,3881,3905
"3939",3024,5359.65,4618.08,-741.570000000001,"increase",9977.73,3846,2166,1680
"3940",3049,7.87,30.96,23.09,"increase",38.83,18,3,15
"3941",3228,0,19.75,19.75,"increase",19.75,9,0,9
"3942",3290,9954.39,7273.99,-2680.4,"increase",17228.38,4958,2643,2315
"3943",3332,4593.01,4241.71,-351.3,"increase",8834.72,3764,1963,1801
"3944",3333,6287.54,6069.44,-218.099999999999,"increase",12356.98,4104,2171,1933
"3945",3423,10214.07,9317.62,-896.449999999999,"increase",19531.69,5042,2679,2363
"3946",3601,160.94,0,-160.94,"increase",160.94,73,73,0
"3947",3802,5174,4996.35,-177.65,"increase",10170.35,4033,2064,1969
"3948",3989,11562.77,8630.77,-2932,"increase",20193.54,5261,3096,2165
"3949",4266,6194.92,7914,1719.08,"increase",14108.92,4539,2005,2534
"3950",4868,0,5.99,5.99,"increase",5.99,1,0,1
"3951",40,1202.96,0,-1202.96,"increase",1202.96,392,392,0
"3952",175,6527.53,7595.92,1068.39,"increase",14123.45,6020,2763,3257
"3953",193,4424.79,3787.55,-637.24,"increase",8212.34,2169,1110,1059
"3954",291,45.65,1325.85,1280.2,"increase",1371.5,372,19,353
"3955",407,8.62,9.78,1.16,"increase",18.4,5,3,2
"3956",412,3268.04,3038.18,-229.86,"increase",6306.22,2596,1326,1270
"3957",633,2317.44,1824.82,-492.62,"increase",4142.26,1639,925,714
"3958",656,6095.99,4492.71,-1603.28,"increase",10588.7,3786,2144,1642
"3959",728,2462.43,2965.56,503.13,"increase",5427.99,2396,1045,1351
"3960",738,543.16,453.01,-90.15,"increase",996.17,241,125,116
"3961",778,2784.79,3123.74,338.95,"increase",5908.53,2357,1180,1177
"3962",788,3849.11,3105.53,-743.58,"increase",6954.64,2695,1346,1349
"3963",910,4822.12,3156.4,-1665.72,"increase",7978.52,2527,1528,999
"3964",1189,5125.61,4161.75,-963.86,"increase",9287.36,3678,1976,1702
"3965",1199,5114.59,6438.32,1323.73,"increase",11552.91,4305,1909,2396
"3966",1289,2991.11,2399.9,-591.21,"increase",5391.01,2162,1117,1045
"3967",1292,2521.5,1887.02,-634.48,"increase",4408.52,2107,1051,1056
"3968",1599,6524.67,6826.62,301.95,"increase",13351.29,4189,2123,2066
"3969",1758,10918.29,10687.93,-230.360000000001,"increase",21606.22,6029,3138,2891
"3970",1760,11.75,15.29,3.54,"increase",27.04,13,6,7
"3971",1781,31.84,0,-31.84,"increase",31.84,7,7,0
"3972",1794,4756.31,5360.78,604.469999999999,"increase",10117.09,4349,2184,2165
"3973",1804,13.68,0,-13.68,"increase",13.68,6,6,0
"3974",2138,2996.4,2627.27,-369.13,"increase",5623.67,3028,1587,1441
"3975",2189,6576.14,5703.85,-872.29,"increase",12279.99,4408,2302,2106
"3976",2216,3243.54,3162.15,-81.3899999999999,"increase",6405.69,2817,1469,1348
"3977",2428,33.27,69.11,35.84,"increase",102.38,55,27,28
"3978",2524,8189.96,9892,1702.04,"increase",18081.96,6773,3087,3686
"3979",2681,3205.28,3749.86,544.58,"increase",6955.14,2090,996,1094
"3980",2752,3284.92,3826.26,541.34,"increase",7111.18,2619,1319,1300
"3981",2920,3153.99,2785.8,-368.19,"increase",5939.79,2566,1322,1244
"3982",2928,1792.93,2459.06,666.13,"increase",4251.99,1913,827,1086
"3983",2961,9118.48,8661.92,-456.559999999999,"increase",17780.4,7516,3781,3735
"3984",3044,560.79,367.08,-193.71,"increase",927.87,395,211,184
"3985",3074,32.86,0,-32.86,"increase",32.86,21,21,0
"3986",3188,0,70.97,70.97,"increase",70.97,24,0,24
"3987",3220,0,2.99,2.99,"increase",2.99,1,0,1
"3988",3398,2801.9,3096.29,294.39,"increase",5898.19,2067,1043,1024
"3989",3587,6576.48,6530.46,-46.0200000000004,"increase",13106.94,5480,2787,2693
"3990",3646,6199.64,6508.15,308.509999999999,"increase",12707.79,5080,2511,2569
"3991",3654,6683.91,7861.24,1177.33,"increase",14545.15,4698,2246,2452
"3992",3715,5868.98,8132.41,2263.43,"increase",14001.39,4853,2075,2778
"3993",3828,127.07,203.11,76.04,"increase",330.18,109,44,65
"3994",3918,2195.14,2012.79,-182.35,"increase",4207.93,1876,990,886
"3995",4429,5287.32,4394.12,-893.2,"increase",9681.44,1825,986,839
"3996",4452,2843.91,2746.34,-97.5699999999997,"increase",5590.25,3358,1640,1718
"3997",4564,6922.64,6699.26,-223.38,"increase",13621.9,6112,3162,2950
"3998",34,2382.98,3608.22,1225.24,"increase",5991.2,1869,739,1130
"3999",66,2436.92,2645.05,208.13,"increase",5081.97,1801,866,935
"4000",67,0,19.25,19.25,"increase",19.25,4,0,4
"4001",102,0,99,99,"increase",99,31,0,31
"4002",290,98.27,0,-98.27,"increase",98.27,29,29,0
"4003",315,5362.69,5220.15,-142.54,"increase",10582.84,3976,1985,1991
"4004",773,6415.85,6002.95,-412.900000000001,"increase",12418.8,3451,1945,1506
"4005",785,1824,1918.58,94.5799999999999,"increase",3742.58,2063,1005,1058
"4006",853,2445.23,2624.69,179.46,"increase",5069.92,1802,877,925
"4007",1002,2653.7,3078.74,425.04,"increase",5732.44,2830,1386,1444
"4008",1019,3528.44,3031.67,-496.77,"increase",6560.11,2154,1157,997
"4009",1028,4059.87,6544.93,2485.06,"increase",10604.8,3372,1277,2095
"4010",1163,3431.49,3892.19,460.7,"increase",7323.68,2381,1103,1278
"4011",1319,0,137.53,137.53,"increase",137.53,46,0,46
"4012",1447,3015.23,3122.16,106.93,"increase",6137.39,2693,1385,1308
"4013",1564,0,490.52,490.52,"increase",490.52,104,0,104
"4014",1837,92.66,52.01,-40.65,"increase",144.67,48,29,19
"4015",1887,6347.52,6255.38,-92.1400000000003,"increase",12602.9,5180,2622,2558
"4016",1945,7083.11,5849.26,-1233.85,"increase",12932.37,4455,2263,2192
"4017",2303,6950.87,6898.66,-52.21,"increase",13849.53,5178,2593,2585
"4018",2306,1159.22,191.53,-967.69,"increase",1350.75,385,340,45
"4019",2393,0,8.27,8.27,"increase",8.27,3,0,3
"4020",2529,0,17.03,17.03,"increase",17.03,11,0,11
"4021",2535,9798.95,9466.17,-332.780000000001,"increase",19265.12,6625,3264,3361
"4022",2767,6394.33,6870.82,476.49,"increase",13265.15,3996,1894,2102
"4023",2773,6898.99,7685.04,786.05,"increase",14584.03,3486,1663,1823
"4024",2862,5771.11,6620.86,849.75,"increase",12391.97,3748,1631,2117
"4025",2896,5956.96,5083.38,-873.58,"increase",11040.34,4118,2130,1988
"4026",2938,5101.66,4859.55,-242.11,"increase",9961.21,3543,1801,1742
"4027",3026,12461.2,8796.64,-3664.56,"increase",21257.84,6663,3973,2690
"4028",3075,7420.08,6085.77,-1334.31,"increase",13505.85,7524,4080,3444
"4029",3081,47.6,0,-47.6,"increase",47.6,20,20,0
"4030",3159,10814,11025.27,211.27,"increase",21839.27,8682,4495,4187
"4031",3444,246.93,210.89,-36.04,"increase",457.82,133,71,62
"4032",3459,2477.36,2443.78,-33.5799999999999,"increase",4921.14,1632,822,810
"4033",3705,2016.11,1856.93,-159.18,"increase",3873.04,1316,668,648
"4034",3742,200.25,192.82,-7.43000000000001,"increase",393.07,145,77,68
"4035",3764,2526.59,2161.35,-365.24,"increase",4687.94,1721,935,786
"4036",3980,135.67,93.49,-42.18,"increase",229.16,86,53,33
"4037",4016,1365.06,1159.95,-205.11,"increase",2525.01,1027,556,471
"4038",4022,4876.75,4222.18,-654.57,"increase",9098.93,3892,2140,1752
"4039",4043,28.75,0,-28.75,"increase",28.75,5,5,0
"4040",4137,4362.71,3915.39,-447.32,"increase",8278.1,2814,1520,1294
"4041",4138,2878.3,4037.74,1159.44,"increase",6916.04,2349,985,1364
"4042",4215,97.97,134.64,36.67,"increase",232.61,63,34,29
"4043",4395,5277.64,5366.77,89.1300000000001,"increase",10644.41,3627,1800,1827
"4044",4663,6285.96,5660.9,-625.06,"increase",11946.86,3907,1927,1980
"4045",4849,3614.28,4247.49,633.21,"increase",7861.77,3251,1643,1608
"4046",4885,5802.28,5073.54,-728.74,"increase",10875.82,3474,1844,1630
"4047",30,38.67,58.09,19.42,"increase",96.76,25,3,22
"4048",222,0,95.61,95.61,"increase",95.61,23,0,23
"4049",233,5752.59,4791.36,-961.23,"increase",10543.95,4229,2322,1907
"4050",244,0,34.58,34.58,"increase",34.58,10,0,10
"4051",340,469.14,0,-469.14,"increase",469.14,135,135,0
"4052",453,7169.01,6273.37,-895.64,"increase",13442.38,5471,2945,2526
"4053",731,6397.06,5512.12,-884.940000000001,"increase",11909.18,3512,1907,1605
"4054",741,1666.64,1891.91,225.27,"increase",3558.55,1278,613,665
"4055",916,2506.17,2904.98,398.81,"increase",5411.15,2225,1129,1096
"4056",1104,0,8.99,8.99,"increase",8.99,2,0,2
"4057",1143,2957.16,1590.01,-1367.15,"increase",4547.17,1515,943,572
"4058",1157,7.29,0,-7.29,"increase",7.29,1,1,0
"4059",1260,4022.78,2590.16,-1432.62,"increase",6612.94,2753,1680,1073
"4060",1273,4700.37,4840.73,140.360000000001,"increase",9541.1,3619,1787,1832
"4061",1544,0,16.86,16.86,"increase",16.86,5,0,5
"4062",1566,2299.98,2450.46,150.48,"increase",4750.44,1766,874,892
"4063",1583,5501.89,5479.86,-22.0300000000007,"increase",10981.75,2743,1400,1343
"4064",1668,5057.95,5140.33,82.3800000000001,"increase",10198.28,3606,1718,1888
"4065",1815,4336.95,3348.58,-988.37,"increase",7685.53,3971,2188,1783
"4066",1921,0,23.46,23.46,"increase",23.46,15,0,15
"4067",2209,4633.47,5535.64,902.17,"increase",10169.11,4023,1894,2129
"4068",2225,1.69,6.79,5.1,"increase",8.48,3,1,2
"4069",2256,3210.62,3907.52,696.9,"increase",7118.14,3231,1582,1649
"4070",2460,131.13,22.15,-108.98,"increase",153.28,43,40,3
"4071",2477,770.21,113.73,-656.48,"increase",883.94,296,259,37
"4072",2645,3872.63,3936.36,63.73,"increase",7808.99,3014,1502,1512
"4073",2714,7529.23,7400.26,-128.97,"increase",14929.49,5670,2901,2769
"4074",2769,3107.8,3242.54,134.74,"increase",6350.34,2437,1236,1201
"4075",2852,3351.18,2521.61,-829.57,"increase",5872.79,1937,1128,809
"4076",2858,7366.04,7592.88,226.84,"increase",14958.92,4548,2357,2191
"4077",2977,3315.06,3858.68,543.62,"increase",7173.74,2410,1207,1203
"4078",3082,61.4,0,-61.4,"increase",61.4,10,10,0
"4079",3098,5611.89,3154.68,-2457.21,"increase",8766.57,2283,1439,844
"4080",3160,148.63,27.02,-121.61,"increase",175.65,37,33,4
"4081",3199,4984.49,5955.55,971.06,"increase",10940.04,2995,1440,1555
"4082",3303,2923.75,1996.37,-927.38,"increase",4920.12,2214,1209,1005
"4083",3321,2917.3,3358.91,441.61,"increase",6276.21,2030,977,1053
"4084",3548,3340.24,3709.61,369.37,"increase",7049.85,2310,1144,1166
"4085",3554,5412.59,5380.71,-31.8800000000001,"increase",10793.3,4243,2178,2065
"4086",3578,6304.24,6032.51,-271.73,"increase",12336.75,4274,2149,2125
"4087",3644,7.49,0,-7.49,"increase",7.49,1,1,0
"4088",3668,5855.85,6356.35,500.5,"increase",12212.2,5128,2352,2776
"4089",3790,4292.89,5071.2,778.309999999999,"increase",9364.09,3688,1702,1986
"4090",3919,9.99,21.4,11.41,"increase",31.39,12,1,11
"4091",4049,105.56,5.78,-99.78,"increase",111.34,41,39,2
"4092",4088,2791.33,3492.2,700.87,"increase",6283.53,1919,854,1065
"4093",4226,2002.46,1470,-532.46,"increase",3472.46,1547,939,608
"4094",7,6386.17,7072.06,685.89,"increase",13458.23,4311,2232,2079
"4095",204,16839.19,16026.98,-812.209999999999,"increase",32866.17,8560,4398,4162
"4096",271,0,125.74,125.74,"increase",125.74,29,0,29
"4097",297,117.78,5.05,-112.73,"increase",122.83,45,39,6
"4098",331,5552.2,5638.98,86.7800000000007,"increase",11191.18,3574,1703,1871
"4099",425,15826.04,13583.57,-2242.47,"increase",29409.61,8732,4752,3980
"4100",477,4779.63,4298.63,-481,"increase",9078.26,4595,2301,2294
"4101",513,9915.59,9208.49,-707.1,"increase",19124.08,6362,3375,2987
"4102",618,1582.6,1306.35,-276.25,"increase",2888.95,1135,625,510
"4103",726,2567.52,2800.61,233.09,"increase",5368.13,2039,971,1068
"4104",804,15289.82,13398.36,-1891.46,"increase",28688.18,8418,4548,3870
"4105",820,1688.96,2168.26,479.3,"increase",3857.22,1606,743,863
"4106",1043,7359.79,5644.4,-1715.39,"increase",13004.19,4996,2902,2094
"4107",1170,14483.73,16789.48,2305.75,"increase",31273.21,10232,4887,5345
"4108",1194,5535.23,5908.66,373.429999999999,"increase",11443.89,4255,2024,2231
"4109",1508,8088.09,8321.77,233.68,"increase",16409.86,7016,3392,3624
"4110",1510,8200.44,7853.06,-347.38,"increase",16053.5,5894,3046,2848
"4111",1555,191.1,63.96,-127.14,"increase",255.06,102,80,22
"4112",1582,1583.17,823.54,-759.63,"increase",2406.71,796,549,247
"4113",1597,97.61,149.38,51.77,"increase",246.99,39,7,32
"4114",1746,0,79.15,79.15,"increase",79.15,43,0,43
"4115",1835,1750.19,2329.84,579.65,"increase",4080.03,1535,671,864
"4116",2113,5437.78,5435.05,-2.72999999999956,"increase",10872.83,4307,2111,2196
"4117",2299,354.53,263.09,-91.44,"increase",617.62,200,120,80
"4118",2351,3896.27,4576.77,680.5,"increase",8473.04,3981,1876,2105
"4119",2354,39.01,83.12,44.11,"increase",122.13,32,11,21
"4120",2436,4446.21,5130.13,683.92,"increase",9576.34,3509,1634,1875
"4121",2463,53.07,192.17,139.1,"increase",245.24,70,16,54
"4122",2493,0,3.24,3.24,"increase",3.24,2,0,2
"4123",2939,4199.38,4348.09,148.71,"increase",8547.47,2550,1244,1306
"4124",3050,64.93,0,-64.93,"increase",64.93,19,19,0
"4125",3107,4232.72,3269.75,-962.97,"increase",7502.47,2506,1416,1090
"4126",3134,5171.85,4916.14,-255.71,"increase",10087.99,3527,1830,1697
"4127",3270,16634.81,16159.6,-475.210000000001,"increase",32794.41,11151,5680,5471
"4128",3346,1553.58,1565.95,12.3700000000001,"increase",3119.53,993,488,505
"4129",3370,3727.25,2194.59,-1532.66,"increase",5921.84,1987,1194,793
"4130",3456,5503.37,5131.52,-371.849999999999,"increase",10634.89,3510,1850,1660
"4131",3487,1719.15,2952.28,1233.13,"increase",4671.43,1511,555,956
"4132",3504,4004.9,2784.05,-1220.85,"increase",6788.95,2270,1350,920
"4133",3547,2381.83,2441.11,59.2800000000002,"increase",4822.94,1824,902,922
"4134",3609,58.28,245.45,187.17,"increase",303.73,79,15,64
"4135",3619,52.93,657.16,604.23,"increase",710.09,213,19,194
"4136",3657,4589.32,3640.2,-949.119999999999,"increase",8229.52,3072,1673,1399
"4137",3677,2151.4,1996.64,-154.76,"increase",4148.04,2395,1154,1241
"4138",3798,5847.21,5739.82,-107.39,"increase",11587.03,4100,2044,2056
"4139",3816,10247.41,11294.44,1047.03,"increase",21541.85,7232,3432,3800
"4140",3863,10440.51,10624.21,183.700000000001,"increase",21064.72,7389,3533,3856
"4141",4009,4484.81,4967.69,482.88,"increase",9452.5,3904,1944,1960
"4142",4035,0,8.46,8.46,"increase",8.46,5,0,5
"4143",4219,10.47,0,-10.47,"increase",10.47,3,3,0
"4144",4738,5080.76,4740.69,-340.07,"increase",9821.45,3092,1632,1460
"4145",4815,5285.81,4398.67,-887.14,"increase",9684.48,3065,1668,1397
"4146",201,3734.18,3403.28,-330.9,"increase",7137.46,2609,1390,1219
"4147",442,0,22.97,22.97,"increase",22.97,3,0,3
"4148",511,8456.76,8437.86,-18.8999999999996,"increase",16894.62,5801,2898,2903
"4149",619,6331.31,5190.37,-1140.94,"increase",11521.68,5532,3151,2381
"4150",663,6969.63,6626.23,-343.4,"increase",13595.86,7797,4127,3670
"4151",703,4320.71,4331.06,10.3500000000004,"increase",8651.77,2491,1170,1321
"4152",704,4151.36,4421.11,269.75,"increase",8572.47,3477,1795,1682
"4153",712,2585.02,3073.96,488.94,"increase",5658.98,2947,1370,1577
"4154",735,1830.6,1910.04,79.4400000000001,"increase",3740.64,1802,866,936
"4155",839,3501.01,3972.46,471.45,"increase",7473.47,2189,1089,1100
"4156",964,3517.4,3295.77,-221.63,"increase",6813.17,2046,1077,969
"4157",1208,2299.67,2914.59,614.92,"increase",5214.26,4548,1841,2707
"4158",1341,6597.17,5643.09,-954.08,"increase",12240.26,5594,3078,2516
"4159",1380,2318.39,2627.3,308.91,"increase",4945.69,2011,899,1112
"4160",1924,2132.59,2032.11,-100.48,"increase",4164.7,1883,947,936
"4161",2432,0,28.48,28.48,"increase",28.48,2,0,2
"4162",2440,0,42.93,42.93,"increase",42.93,14,0,14
"4163",2639,116.62,179.86,63.24,"increase",296.48,112,47,65
"4164",2966,5580.92,4852.67,-728.25,"increase",10433.59,3933,2160,1773
"4165",2967,319.46,251.82,-67.64,"increase",571.28,185,101,84
"4166",3777,2609.6,3047.38,437.78,"increase",5656.98,2115,990,1125
"4167",3827,75.56,0,-75.56,"increase",75.56,22,22,0
"4168",4261,3895.33,3766.61,-128.72,"increase",7661.94,2775,1372,1403
"4169",44,522.47,349.19,-173.28,"increase",871.66,300,188,112
"4170",84,30.23,0,-30.23,"increase",30.23,7,7,0
"4171",940,8369.61,6992.39,-1377.22,"increase",15362,4630,2602,2028
"4172",1778,10179.29,11701.61,1522.32,"increase",21880.9,7324,3586,3738
"4173",2969,7199.44,5186.59,-2012.85,"increase",12386.03,3763,2133,1630
"4174",3756,10999.8,10902.61,-97.1899999999987,"increase",21902.41,5399,2695,2704
"4175",289,17,0,-17,"increase",17,12,12,0
"4176",460,1053.42,0,-1053.42,"increase",1053.42,351,351,0
"4177",539,12311.42,9125.84,-3185.58,"increase",21437.26,7514,4342,3172
"4178",606,1231.85,1608.2,376.35,"increase",2840.05,967,460,507
"4179",1071,5992.99,5901.6,-91.3899999999994,"increase",11894.59,5004,2579,2425
"4180",1090,11.36,0,-11.36,"increase",11.36,4,4,0
"4181",1265,1616.14,1226.07,-390.07,"increase",2842.21,1041,631,410
"4182",1631,13.42,0,-13.42,"increase",13.42,6,6,0
"4183",1643,94.54,0,-94.54,"increase",94.54,10,10,0
"4184",2058,2557.02,2892.11,335.09,"increase",5449.13,2315,1136,1179
"4185",2244,8820.08,9200.47,380.389999999999,"increase",18020.55,6009,2811,3198
"4186",2380,6977.28,5494.19,-1483.09,"increase",12471.47,4456,2655,1801
"4187",2737,4622.13,5175.98,553.85,"increase",9798.11,3716,1731,1985
"4188",3012,3389.59,3222.72,-166.87,"increase",6612.31,2681,1368,1313
"4189",3216,5782.27,6778.02,995.75,"increase",12560.29,4237,1836,2401
"4190",3538,3167.75,3529.89,362.14,"increase",6697.64,2619,1209,1410
"4191",3555,4910.4,4546.78,-363.620000000001,"increase",9457.18,3031,1544,1487
"4192",147,7750.25,7297.31,-452.94,"increase",15047.56,4375,2177,2198
"4193",343,0,5.48,5.48,"increase",5.48,2,0,2
"4194",502,1188.37,2542.22,1353.85,"increase",3730.59,1300,479,821
"4195",768,1174.06,1262.24,88.1800000000001,"increase",2436.3,1623,838,785
"4196",801,4085.27,4629.62,544.35,"increase",8714.89,3959,1876,2083
"4197",1112,492.6,450.63,-41.97,"increase",943.23,316,154,162
"4198",1618,3705.05,4073.55,368.5,"increase",7778.6,2981,1427,1554
"4199",2083,7698.57,7083.44,-615.129999999999,"increase",14782.01,3190,1750,1440
"4200",2194,3437.65,4194.99,757.34,"increase",7632.64,2173,979,1194
"4201",2561,0,101.69,101.69,"increase",101.69,30,0,30
"4202",2823,3393.63,3642.25,248.62,"increase",7035.88,2448,1201,1247
"4203",2885,2653.42,2400.26,-253.16,"increase",5053.68,1897,1023,874
"4204",2899,4820.74,3028.53,-1792.21,"increase",7849.27,2627,1610,1017
"4205",3311,4764.25,5782.66,1018.41,"increase",10546.91,4071,1859,2212
"4206",3384,2861.52,3581.75,720.23,"increase",6443.27,2330,1062,1268
"4207",3403,6258.82,5388.82,-870,"increase",11647.64,3127,1732,1395
"4208",3486,946.92,998.31,51.3900000000001,"increase",1945.23,986,487,499
"4209",3542,2918.79,3680.19,761.4,"increase",6598.98,2854,1191,1663
"4210",3594,6726.18,6568.46,-157.72,"increase",13294.64,3266,1604,1662
"4211",4052,3150.94,2748.84,-402.1,"increase",5899.78,2315,1212,1103
"4212",4107,4153.28,4866.3,713.02,"increase",9019.58,2532,1184,1348
"4213",458,3.99,0,-3.99,"increase",3.99,1,1,0
"4214",1145,2406.09,1974.64,-431.45,"increase",4380.73,2054,1186,868
"4215",1399,0,363.34,363.34,"increase",363.34,99,0,99
"4216",1970,11687.44,11407.82,-279.620000000001,"increase",23095.26,9139,4505,4634
"4217",2551,9356.48,7885.41,-1471.07,"increase",17241.89,4162,2302,1860
"4218",2603,2841.47,1566.54,-1274.93,"increase",4408.01,1542,957,585
"4219",3201,8285.67,9755.35,1469.68,"increase",18041.02,5393,2585,2808
"4220",3275,33.9,416.07,382.17,"increase",449.97,208,11,197
"4221",3590,4503.59,4231.11,-272.48,"increase",8734.7,2757,1371,1386
"4222",4020,3862.76,3980.95,118.19,"increase",7843.71,3323,1621,1702
"4223",4050,7388.02,7460.84,72.8199999999997,"increase",14848.86,4879,2443,2436
"4224",1604,8827.24,8782.98,-44.2600000000002,"increase",17610.22,4034,1953,2081
"4225",1634,4150.99,5835.8,1684.81,"increase",9986.79,3058,1295,1763
"4226",2560,11680.77,11934.89,254.119999999999,"increase",23615.66,6204,3153,3051
"4227",4648,2380.89,3647.73,1266.84,"increase",6028.62,2378,976,1402
"4228",4761,20.02,28.02,8,"increase",48.04,16,10,6
"4229",221,35.35,0,-35.35,"increase",35.35,7,7,0
"4230",275,42.05,0,-42.05,"increase",42.05,14,14,0
"4231",335,9.49,0,-9.49,"increase",9.49,1,1,0
"4232",420,143.14,83.18,-59.96,"increase",226.32,110,71,39
"4233",554,6188.75,5502.65,-686.1,"increase",11691.4,4967,2465,2502
"4234",702,1787.41,1697.01,-90.4000000000001,"increase",3484.42,1659,855,804
"4235",740,5210.09,5410.76,200.67,"increase",10620.85,3748,1858,1890
"4236",744,2252.7,2496.09,243.39,"increase",4748.79,1740,917,823
"4237",824,2666.34,1660.86,-1005.48,"increase",4327.2,2238,1391,847
"4238",851,3147.7,3484.9,337.2,"increase",6632.6,2528,1201,1327
"4239",872,7758.51,5859.14,-1899.37,"increase",13617.65,6138,3481,2657
"4240",959,4735.93,3790.49,-945.44,"increase",8526.42,2575,1429,1146
"4241",984,2988.87,3832.1,843.23,"increase",6820.97,3193,1537,1656
"4242",1046,3328.35,3120.71,-207.64,"increase",6449.06,2120,1079,1041
"4243",1115,21.47,276.69,255.22,"increase",298.16,80,8,72
"4244",1144,3580.35,3210.77,-369.58,"increase",6791.12,2528,1471,1057
"4245",1147,5976.38,4641.73,-1334.65,"increase",10618.11,3968,2344,1624
"4246",1166,5125.16,5170.59,45.4300000000003,"increase",10295.75,4599,2259,2340
"4247",1244,5048.97,6643.3,1594.33,"increase",11692.27,3900,1784,2116
"4248",1295,7318.06,3870.49,-3447.57,"increase",11188.55,3326,2336,990
"4249",1375,3306.25,3361.31,55.0599999999999,"increase",6667.56,2012,1012,1000
"4250",1429,50.24,15.34,-34.9,"increase",65.58,22,16,6
"4251",1466,9.92,47.53,37.61,"increase",57.45,23,6,17
"4252",1497,3216.24,3762.51,546.27,"increase",6978.75,3091,1522,1569
"4253",1690,4696.49,4145.94,-550.55,"increase",8842.43,4482,2409,2073
"4254",1769,0,55.04,55.04,"increase",55.04,29,0,29
"4255",1777,2680.1,2742,61.9000000000001,"increase",5422.1,2734,1339,1395
"4256",1902,4440.51,3554.96,-885.55,"increase",7995.47,2366,1330,1036
"4257",1942,3227.5,2947.97,-279.53,"increase",6175.47,2461,1352,1109
"4258",2296,4199.3,4433.04,233.74,"increase",8632.34,2689,1212,1477
"4259",2449,125.13,0,-125.13,"increase",125.13,30,30,0
"4260",2523,5575.62,4105.33,-1470.29,"increase",9680.95,4729,2597,2132
"4261",2604,3296.72,3249.31,-47.4099999999999,"increase",6546.03,3070,1567,1503
"4262",2614,2620.38,3257.23,636.85,"increase",5877.61,2843,1329,1514
"4263",2635,2562.8,2634.59,71.79,"increase",5197.39,1832,876,956
"4264",2700,3636.07,3619.03,-17.04,"increase",7255.1,3426,1748,1678
"4265",2718,3577.46,8482.57,4905.11,"increase",12060.03,3726,1123,2603
"4266",2798,10.86,0,-10.86,"increase",10.86,5,5,0
"4267",3117,2991.89,4043.92,1052.03,"increase",7035.81,2424,1013,1411
"4268",3288,6.98,0,-6.98,"increase",6.98,2,2,0
"4269",3457,4812.39,4356.6,-455.79,"increase",9168.99,3142,1726,1416
"4270",3460,32.13,0,-32.13,"increase",32.13,16,16,0
"4271",3629,4228.98,4065.13,-163.85,"increase",8294.11,3575,1826,1749
"4272",3844,2247.34,6365.21,4117.87,"increase",8612.55,3234,948,2286
"4273",3950,8.48,0,-8.48,"increase",8.48,2,2,0
"4274",4039,12112.47,9912.62,-2199.85,"increase",22025.09,7489,4242,3247
"4275",4125,8782.25,6552.46,-2229.79,"increase",15334.71,4512,2613,1899
"4276",4168,3788.65,3554.22,-234.43,"increase",7342.87,2906,1492,1414
"4277",4277,144.83,17.26,-127.57,"increase",162.09,49,41,8
"4278",4307,2655.17,2897.75,242.58,"increase",5552.92,1764,891,873
"4279",4421,1607.25,1867.8,260.55,"increase",3475.05,2550,1108,1442
"4280",4941,4613.25,5188.46,575.21,"increase",9801.71,3534,1692,1842
"4281",3051,4288.59,3845.77,-442.82,"increase",8134.36,3434,1784,1650
"4282",723,4009.86,4598.97,589.11,"increase",8608.83,2609,1252,1357
"4283",3494,0,31.5,31.5,"increase",31.5,6,0,6
"4284",865,258.99,755.47,496.48,"increase",1014.46,224,50,174
"4285",1683,11811.74,9011.2,-2800.54,"increase",20822.94,5805,3326,2479
"4286",3879,7916.63,3377.07,-4539.56,"increase",11293.7,4066,2953,1113
"4287",3945,0,24.98,24.98,"increase",24.98,2,0,2
"4288",3946,0,469.68,469.68,"increase",469.68,185,0,185
"4289",2719,3886.03,4267.46,381.43,"increase",8153.49,2526,1219,1307
"4290",152,2348.81,3496.34,1147.53,"increase",5845.15,3366,1361,2005
"4291",3001,3747.94,2374.85,-1373.09,"increase",6122.79,2853,1619,1234
"4292",4923,3696.48,4153.1,456.62,"increase",7849.58,2927,1422,1505
"4293",2319,6034.8,6704.85,670.05,"increase",12739.65,4610,2315,2295
"4294",2472,578.4,315.19,-263.21,"increase",893.59,317,210,107
"4295",2986,7532.67,9343.67,1811,"increase",16876.34,4809,2192,2617
"4296",3263,0,31.46,31.46,"increase",31.46,9,0,9
"4297",1075,0,12.18,12.18,"increase",12.18,2,0,2
"4298",4309,3242.84,4854.51,1611.67,"increase",8097.35,3565,1427,2138
"4299",4423,6139.86,6415.26,275.400000000001,"increase",12555.12,5053,2532,2521
"4300",2627,11888.02,11691.24,-196.780000000001,"increase",23579.26,9246,4547,4699
"4301",3104,0,18.12,18.12,"increase",18.12,10,0,10
"4302",3518,2836.34,2827.2,-9.13999999999987,"increase",5663.54,1852,917,935
"4303",2091,1112.86,1698.17,585.31,"increase",2811.03,951,350,601
"4304",388,6.68,0,-6.68,"increase",6.68,2,2,0
"4305",683,14.96,0,-14.96,"increase",14.96,4,4,0
"4306",1020,7752.59,7944.47,191.88,"increase",15697.06,5668,2865,2803
"4307",1098,0,16.94,16.94,"increase",16.94,5,0,5
"4308",1585,12.72,0,-12.72,"increase",12.72,5,5,0
"4309",1638,85.23,26,-59.23,"increase",111.23,31,20,11
"4310",1807,5851.43,5059.37,-792.06,"increase",10910.8,3402,1827,1575
"4311",2814,3417.35,3560.07,142.72,"increase",6977.42,1754,828,926
"4312",3174,0,316.83,316.83,"increase",316.83,105,0,105
"4313",3264,9514.75,8881.66,-633.09,"increase",18396.41,7102,3659,3443
"4314",4249,555.25,416.07,-139.18,"increase",971.32,193,98,95
"4315",4670,6716.24,7284.4,568.160000000001,"increase",14000.64,3927,2004,1923
"4316",431,205.3,154.71,-50.59,"increase",360.01,176,110,66
"4317",1290,5904.13,5982.52,78.3900000000003,"increase",11886.65,4796,2560,2236
"4318",1678,12498.41,14307.92,1809.51,"increase",26806.33,9644,4490,5154
"4319",2810,4673.94,3350.97,-1322.97,"increase",8024.91,3359,1973,1386
"4320",3809,22.2,0,-22.2,"increase",22.2,11,11,0
"4321",3914,41.44,243.09,201.65,"increase",284.53,95,9,86
"4322",4053,69.46,0,-69.46,"increase",69.46,14,14,0
"4323",4210,6330.19,7094.69,764.5,"increase",13424.88,3962,1854,2108
"4324",4231,4556.08,5031.59,475.51,"increase",9587.67,4041,2088,1953
"4325",4806,5392.95,6954.15,1561.2,"increase",12347.1,3369,1403,1966
"4326",207,18.26,0,-18.26,"increase",18.26,4,4,0
"4327",345,0,82.86,82.86,"increase",82.86,32,0,32
"4328",491,8.68,8.98,0.300000000000001,"increase",17.66,6,4,2
"4329",565,140.73,10.43,-130.3,"increase",151.16,51,44,7
"4330",601,6196.51,6217.07,20.5599999999995,"increase",12413.58,4398,2252,2146
"4331",789,2536.28,1661.35,-874.93,"increase",4197.63,1809,1088,721
"4332",887,7470.09,6291.53,-1178.56,"increase",13761.62,4734,2564,2170
"4333",1254,8298.5,7254.43,-1044.07,"increase",15552.93,5375,2668,2707
"4334",1257,7336.59,7675.31,338.72,"increase",15011.9,5339,2820,2519
"4335",1288,9193.6,10341.26,1147.66,"increase",19534.86,8247,4031,4216
"4336",1735,12130.49,13643.41,1512.92,"increase",25773.9,7916,3812,4104
"4337",2132,7733.05,4341.21,-3391.84,"increase",12074.26,3876,2568,1308
"4338",2424,6344.2,11581.53,5237.33,"increase",17925.73,6094,2307,3787
"4339",3952,4.58,0,-4.58,"increase",4.58,3,3,0
"4340",4239,7743.93,9748,2004.07,"increase",17491.93,7644,3543,4101
"4341",4925,13564.17,13957.48,393.309999999999,"increase",27521.65,9359,4580,4779
"4342",1339,11656.17,11080.39,-575.780000000001,"increase",22736.56,6789,3559,3230
"4343",1362,1350.07,2919.67,1569.6,"increase",4269.74,1779,575,1204
"4344",1913,2736.98,1838.28,-898.7,"increase",4575.26,1670,1002,668
"4345",2095,5594.5,6096.21,501.71,"increase",11690.71,5522,2648,2874
"4346",2455,3704.52,4222.82,518.3,"increase",7927.34,3266,1567,1699
"4347",2544,12.78,0,-12.78,"increase",12.78,7,7,0
"4348",2811,6088.71,5556.93,-531.78,"increase",11645.64,4331,2202,2129
"4349",3367,0,120.5,120.5,"increase",120.5,23,0,23
"4350",4581,7.75,114.13,106.38,"increase",121.88,41,4,37
"4351",4608,5742.32,4256.28,-1486.04,"increase",9998.6,3583,2033,1550
"4352",1266,16283.81,14898.25,-1385.56,"increase",31182.06,8297,4399,3898
"4353",1500,9522.74,6785.64,-2737.1,"increase",16308.38,4894,2798,2096
"4354",1505,6818.9,7677.52,858.62,"increase",14496.42,5622,2640,2982
"4355",1677,5815.44,8696.35,2880.91,"increase",14511.79,4922,2049,2873
"4356",1774,0,30,30,"increase",30,12,0,12
"4357",1790,87.67,172.74,85.07,"increase",260.41,82,27,55
"4358",1990,7006.73,6821.49,-185.240000000001,"increase",13828.22,5587,2816,2771
"4359",2045,0,123.22,123.22,"increase",123.22,33,0,33
"4360",2653,7302.39,7330.09,27.6999999999998,"increase",14632.48,6571,3129,3442
"4361",3116,13909.83,13596.12,-313.709999999999,"increase",27505.95,8332,4582,3750
"4362",3210,2004.7,180.14,-1824.56,"increase",2184.84,585,532,53
"4363",3331,0,83.7,83.7,"increase",83.7,25,0,25
"4364",3623,3037.57,1259.23,-1778.34,"increase",4296.8,1397,954,443
"4365",3703,209.98,141.34,-68.64,"increase",351.32,142,87,55
"4366",3799,12585.48,13498.31,912.83,"increase",26083.79,8107,3942,4165
"4367",3977,7405.86,9558.18,2152.32,"increase",16964.04,4627,2103,2524
"4368",4256,5830.86,9342.46,3511.6,"increase",15173.32,4778,1708,3070
"4369",4482,84.52,0,-84.52,"increase",84.52,10,10,0
"4370",4665,11855.98,7253.28,-4602.7,"increase",19109.26,5873,3493,2380
"4371",786,3441.21,2532.39,-908.82,"increase",5973.6,1967,1116,851
"4372",1322,4150.24,3858.55,-291.69,"increase",8008.79,2899,1485,1414
"4373",1755,4206.52,6621.08,2414.56,"increase",10827.6,4704,1783,2921
"4374",1879,10.96,23.66,12.7,"increase",34.62,9,5,4
"4375",1931,2734.46,2436.63,-297.83,"increase",5171.09,1921,992,929
"4376",2086,3578.27,4175.48,597.21,"increase",7753.75,3117,1472,1645
"4377",2099,4.88,3.99,-0.89,"increase",8.87,4,3,1
"4378",2500,2466.79,2501.48,34.6900000000001,"increase",4968.27,2412,1206,1206
"4379",3365,4808.45,4294.49,-513.96,"increase",9102.94,3382,1900,1482
"4380",208,18.19,0,-18.19,"increase",18.19,12,12,0
"4381",438,0,5,5,"increase",5,4,0,4
"4382",493,250.24,200.66,-49.58,"increase",450.9,157,80,77
"4383",790,12739.77,14231.31,1491.54,"increase",26971.08,8298,3915,4383
"4384",909,603.77,868.15,264.38,"increase",1471.92,516,215,301
"4385",1086,0,15.27,15.27,"increase",15.27,3,0,3
"4386",1108,0,42.9,42.9,"increase",42.9,10,0,10
"4387",1152,9044.76,9210.65,165.889999999999,"increase",18255.41,5845,3077,2768
"4388",1276,12268.85,13270.68,1001.83,"increase",25539.53,8722,4318,4404
"4389",1349,36.23,0,-36.23,"increase",36.23,16,16,0
"4390",1584,10676.78,9999.13,-677.65,"increase",20675.91,6736,3301,3435
"4391",1659,95.83,0,-95.83,"increase",95.83,31,31,0
"4392",2015,4601.36,3958.65,-642.71,"increase",8560.01,1978,1129,849
"4393",2016,10697.39,10123.7,-573.689999999999,"increase",20821.09,6612,3202,3410
"4394",2098,6408.17,11391.45,4983.28,"increase",17799.62,4991,1518,3473
"4395",2412,1378.23,429.06,-949.17,"increase",1807.29,383,293,90
"4396",2615,5180.75,10190.45,5009.7,"increase",15371.2,5645,2298,3347
"4397",2987,5149.14,4803.97,-345.17,"increase",9953.11,3135,1554,1581
"4398",3208,70.93,284.1,213.17,"increase",355.03,68,9,59
"4399",3287,9.24,0,-9.24,"increase",9.24,5,5,0
"4400",3447,4839.09,4923.02,83.9300000000003,"increase",9762.11,3067,1628,1439
"4401",3495,11.76,18,6.24,"increase",29.76,18,8,10
"4402",3642,214.92,1054.67,839.75,"increase",1269.59,304,68,236
"4403",4158,3852.44,2024.92,-1827.52,"increase",5877.36,1866,1240,626
"4404",4513,4416.23,4946.92,530.69,"increase",9363.15,3010,1436,1574
"4405",4747,5426.68,5549.8,123.12,"increase",10976.48,3003,1475,1528
"4406",10,2838.58,2888.02,49.4400000000001,"increase",5726.6,1971,961,1010
"4407",610,144.52,0,-144.52,"increase",144.52,34,34,0
"4408",667,167.67,0,-167.67,"increase",167.67,67,67,0
"4409",1253,9071.47,8981.55,-89.9200000000001,"increase",18053.02,7095,3732,3363
"4410",1442,7117.99,5253.45,-1864.54,"increase",12371.44,3330,1853,1477
"4411",1757,5392.06,5905.54,513.48,"increase",11297.6,5258,2400,2858
"4412",2003,7498.56,7150.09,-348.47,"increase",14648.65,6721,3600,3121
"4413",2024,8621.02,9487.29,866.27,"increase",18108.31,8291,4149,4142
"4414",2186,8279.9,10893.49,2613.59,"increase",19173.39,6856,3031,3825
"4415",2213,3638.92,5205.63,1566.71,"increase",8844.55,4401,1935,2466
"4416",2346,6283.33,4801.48,-1481.85,"increase",11084.81,1942,1116,826
"4417",2859,12.36,0,-12.36,"increase",12.36,4,4,0
"4418",3156,4583.35,3787.51,-795.84,"increase",8370.86,3798,1955,1843
"4419",3163,5753.73,5432.9,-320.830000000001,"increase",11186.63,3556,1833,1723
"4420",3292,4.49,0,-4.49,"increase",4.49,1,1,0
"4421",3475,1243.85,738.96,-504.89,"increase",1982.81,904,581,323
"4422",3672,7090.11,7786.94,696.830000000001,"increase",14877.05,4944,2422,2522
"4423",4383,5856.41,5601.78,-254.63,"increase",11458.19,3190,1608,1582
"4424",134,7135.57,10092.66,2957.09,"increase",17228.23,7692,3352,4340
"4425",170,7567.2,6287.21,-1279.99,"increase",13854.41,5839,3006,2833
"4426",317,1695.27,2498.34,803.07,"increase",4193.61,1359,595,764
"4427",581,6904.63,6550.39,-354.24,"increase",13455.02,4521,2392,2129
"4428",1235,11268.49,12013.08,744.59,"increase",23281.57,10733,5118,5615
"4429",1278,2155.64,2279.48,123.84,"increase",4435.12,1976,955,1021
"4430",1376,12848.38,14617.95,1769.57,"increase",27466.33,10623,5130,5493
"4431",2074,3412.27,5419.33,2007.06,"increase",8831.6,3134,1229,1905
"4432",2402,32,176.38,144.38,"increase",208.38,95,14,81
"4433",2503,16576.83,20820.47,4243.64,"increase",37397.3,10363,4484,5879
"4434",2674,7547.29,7836.57,289.28,"increase",15383.86,5357,2570,2787
"4435",2925,3531.22,4878.66,1347.44,"increase",8409.88,2962,1126,1836
"4436",2943,5529.02,3878.96,-1650.06,"increase",9407.98,3532,2135,1397
"4437",3155,3659.48,6035.59,2376.11,"increase",9695.07,3602,1429,2173
"4438",3169,8380.43,8047.7,-332.73,"increase",16428.13,5395,2897,2498
"4439",3471,2668.91,2657.54,-11.3699999999999,"increase",5326.45,2023,969,1054
"4440",3484,1874.52,2721.64,847.12,"increase",4596.16,1685,709,976
"4441",3565,4103.81,7831.1,3727.29,"increase",11934.91,4859,1637,3222
"4442",3852,6649.35,6600.77,-48.5799999999999,"increase",13250.12,5108,2708,2400
"4443",3992,1.98,35.99,34.01,"increase",37.97,15,3,12
"4444",4033,77.27,24.45,-52.82,"increase",101.72,24,17,7
"4445",4062,0,49.48,49.48,"increase",49.48,29,0,29
"4446",4536,22.47,0,-22.47,"increase",22.47,12,12,0
"4447",182,0,242.51,242.51,"increase",242.51,34,0,34
"4448",265,5016.86,5961.63,944.77,"increase",10978.49,3642,1672,1970
"4449",823,3010.91,3604.94,594.03,"increase",6615.85,2312,1005,1307
"4450",1488,7334.3,5775.18,-1559.12,"increase",13109.48,4636,2571,2065
"4451",1811,4634.66,7899.71,3265.05,"increase",12534.37,4122,1556,2566
"4452",1883,6303.86,7133.55,829.690000000001,"increase",13437.41,3977,1780,2197
"4453",2669,4225.67,3546.38,-679.29,"increase",7772.05,3360,1613,1747
"4454",2729,4647.56,4065.58,-581.98,"increase",8713.14,2691,1520,1171
"4455",2877,5214.09,7637.99,2423.9,"increase",12852.08,4398,1712,2686
"4456",3394,1720.53,1364.99,-355.54,"increase",3085.52,1302,728,574
"4457",3414,2916.51,3200.2,283.69,"increase",6116.71,1430,916,514
"4458",3508,4937.73,4930.51,-7.22000000000025,"increase",9868.24,4865,2491,2374
"4459",3885,5496.75,4312.8,-1183.95,"increase",9809.55,2666,1446,1220
"4460",3941,0,18.77,18.77,"increase",18.77,3,0,3
"4461",4718,4074.86,3513.74,-561.12,"increase",7588.6,2770,1526,1244
"4462",298,378.29,666.23,287.94,"increase",1044.52,106,41,65
"4463",487,31.49,0,-31.49,"increase",31.49,5,5,0
"4464",585,12399.72,10846.89,-1552.83,"increase",23246.61,6338,3346,2992
"4465",605,3238.04,1958.19,-1279.85,"increase",5196.23,1599,952,647
"4466",659,20.45,0,-20.45,"increase",20.45,6,6,0
"4467",1084,151.28,0,-151.28,"increase",151.28,51,51,0
"4468",1313,6052.25,4479.6,-1572.65,"increase",10531.85,3719,2069,1650
"4469",1523,3205.37,521.11,-2684.26,"increase",3726.48,1058,911,147
"4470",1571,1392.68,2221.54,828.86,"increase",3614.22,1390,549,841
"4471",2696,7945.52,9618.06,1672.54,"increase",17563.58,6555,3019,3536
"4472",2731,4305.06,4074.4,-230.66,"increase",8379.46,3113,1611,1502
"4473",2791,5388.3,7254.82,1866.52,"increase",12643.12,3650,1550,2100
"4474",2911,2075.93,2085.92,9.99000000000024,"increase",4161.85,2014,1046,968
"4475",2940,4777.85,5377.07,599.219999999999,"increase",10154.92,2670,1076,1594
"4476",3019,4490.54,3615.26,-875.28,"increase",8105.8,2784,1555,1229
"4477",3069,6586.36,6746.21,159.85,"increase",13332.57,3397,1639,1758
"4478",3195,0,24.24,24.24,"increase",24.24,6,0,6
"4479",3215,106.91,0,-106.91,"increase",106.91,9,9,0
"4480",3402,7912.91,7417.52,-495.389999999999,"increase",15330.43,4963,2654,2309
"4481",3549,690.68,1008.67,317.99,"increase",1699.35,518,220,298
"4482",3682,185.51,0,-185.51,"increase",185.51,69,69,0
"4483",4111,305.93,0,-305.93,"increase",305.93,78,78,0
"4484",4625,7161.23,8211.3,1050.07,"increase",15372.53,5253,2419,2834
"4485",4723,5451.7,6174.76,723.06,"increase",11626.46,3907,1824,2083
"4486",501,2973.09,2264.9,-708.19,"increase",5237.99,1809,1024,785
"4487",861,2303.94,3659.41,1355.47,"increase",5963.35,2779,1158,1621
"4488",1324,6364.67,6134.24,-230.43,"increase",12498.91,2993,1425,1568
"4489",1575,0,159.21,159.21,"increase",159.21,38,0,38
"4490",1707,4849.42,2804.28,-2045.14,"increase",7653.7,2798,1738,1060
"4491",2426,6389.77,7406.8,1017.03,"increase",13796.57,5725,2687,3038
"4492",4409,9300.16,6279.62,-3020.54,"increase",15579.78,5744,3432,2312
"4493",4740,6392.44,4924.76,-1467.68,"increase",11317.2,4353,2202,2151
"4494",4814,5717.21,7077.79,1360.58,"increase",12795,4319,2218,2101
"4495",80,2.78,0,-2.78,"increase",2.78,2,2,0
"4496",135,0,365.57,365.57,"increase",365.57,89,0,89
"4497",160,14774.03,13980.48,-793.550000000001,"increase",28754.51,9061,4544,4517
"4498",256,0,599.82,599.82,"increase",599.82,202,0,202
"4499",840,7722.01,5408.01,-2314,"increase",13130.02,5812,3368,2444
"4500",970,16035.49,14358.66,-1676.83,"increase",30394.15,7659,4061,3598
"4501",2096,3244.46,3597.61,353.15,"increase",6842.07,1447,638,809
"4502",2446,3.97,2,-1.97,"increase",5.97,4,3,1
"4503",2801,7616.01,7874.58,258.57,"increase",15490.59,6616,3231,3385
"4504",2957,177.57,252.14,74.57,"increase",429.71,146,39,107
"4505",3029,12106.38,4894.9,-7211.48,"increase",17001.28,5111,3537,1574
"4506",3106,13.07,0,-13.07,"increase",13.07,8,8,0
"4507",3314,4294.31,4194.58,-99.7300000000005,"increase",8488.89,1914,983,931
"4508",3349,14499.09,12436.61,-2062.48,"increase",26935.7,8262,4409,3853
"4509",3770,2151.21,1340.41,-810.8,"increase",3491.62,1199,744,455
"4510",266,0,3.99,3.99,"increase",3.99,1,0,1
"4511",302,58.01,6.79,-51.22,"increase",64.8,27,23,4
"4512",797,5592.82,5516.03,-76.79,"increase",11108.85,3239,1688,1551
"4513",929,5991.4,6278.66,287.26,"increase",12270.06,3171,1567,1604
"4514",1648,5100.88,5257.79,156.91,"increase",10358.67,5301,2694,2607
"4515",1847,11868.99,15426.01,3557.02,"increase",27295,9133,4028,5105
"4516",2466,3613.73,3478.52,-135.21,"increase",7092.25,2569,1398,1171
"4517",2595,6585.54,3636.42,-2949.12,"increase",10221.96,3910,2412,1498
"4518",2602,2922.4,2732.65,-189.75,"increase",5655.05,2767,1433,1334
"4519",3604,144.94,24.33,-120.61,"increase",169.27,113,92,21
"4520",3611,7476.85,6733.83,-743.02,"increase",14210.68,5356,2846,2510
"4521",3711,27.19,13.46,-13.73,"increase",40.65,28,17,11
"4522",3747,617.15,396.71,-220.44,"increase",1013.86,489,296,193
"4523",3884,3753.02,5320.54,1567.52,"increase",9073.56,3762,1535,2227
"4524",435,32.12,12.62,-19.5,"increase",44.74,22,15,7
"4525",698,1892.16,2369.06,476.9,"increase",4261.22,1705,759,946
"4526",1022,0,0.69,0.69,"increase",0.69,1,0,1
"4527",1030,12961.26,13292.07,330.809999999999,"increase",26253.33,7468,3853,3615
"4528",1050,15554.62,14890.6,-664.02,"increase",30445.22,10744,5373,5371
"4529",1051,15554.62,14890.6,-664.02,"increase",30445.22,10744,5373,5371
"4530",1167,3422.87,3444.91,22.04,"increase",6867.78,2894,1413,1481
"4531",2012,7673.99,8969.18,1295.19,"increase",16643.17,3489,1611,1878
"4532",2712,3918.9,3241.22,-677.68,"increase",7160.12,2891,1667,1224
"4533",2782,3646.8,4973.42,1326.62,"increase",8620.22,3158,1411,1747
"4534",3005,0,10.99,10.99,"increase",10.99,5,0,5
"4535",3176,5182.26,4100.96,-1081.3,"increase",9283.22,3427,1745,1682
"4536",3470,7932.92,9261.02,1328.1,"increase",17193.94,6636,3204,3432
"4537",3511,2900.55,7753.52,4852.97,"increase",10654.07,4354,1179,3175
"4538",3640,426.3,1111.91,685.61,"increase",1538.21,503,155,348
"4539",3755,2043.07,2049.78,6.71000000000026,"increase",4092.85,1674,869,805
"4540",3889,447.41,551.91,104.5,"increase",999.32,331,142,189
"4541",3932,10310.4,10846.99,536.59,"increase",21157.39,7289,3746,3543
"4542",48,7244.48,7682.83,438.349999999999,"increase",14927.31,4622,2210,2412
"4543",154,1486.9,1467.29,-19.6100000000001,"increase",2954.19,556,283,273
"4544",196,3193.15,3447.78,254.63,"increase",6640.93,2360,1144,1216
"4545",787,5541.82,5278.52,-263.299999999999,"increase",10820.34,4513,2351,2162
"4546",1369,5975.95,6075.33,99.3800000000001,"increase",12051.28,4386,2252,2134
"4547",3491,5010,2599.46,-2410.54,"increase",7609.46,2466,1581,885
"4548",3641,3180.48,3391.2,210.72,"increase",6571.68,2682,1296,1386
"4549",3723,0,8.49,8.49,"increase",8.49,2,0,2
"4550",3794,5931.05,3687.54,-2243.51,"increase",9618.59,3514,2044,1470
"4551",3803,28.82,14.62,-14.2,"increase",43.44,16,11,5
"4552",3876,52.18,22.66,-29.52,"increase",74.84,20,13,7
"4553",156,13.47,0,-13.47,"increase",13.47,3,3,0
"4554",167,3660.9,2698.3,-962.6,"increase",6359.2,2463,1383,1080
"4555",418,0,63.28,63.28,"increase",63.28,17,0,17
"4556",2156,2708.79,2881.4,172.61,"increase",5590.19,3101,1550,1551
"4557",2437,5866.01,5701.61,-164.400000000001,"increase",11567.62,3722,2076,1646
"4558",2438,0,6.49,6.49,"increase",6.49,1,0,1
"4559",2461,5756.05,4000.91,-1755.14,"increase",9756.96,3172,1914,1258
"4560",2467,50.05,75.48,25.43,"increase",125.53,33,14,19
"4561",2713,2670.46,2497.64,-172.82,"increase",5168.1,1691,866,825
"4562",3193,7.03,9.78,2.75,"increase",16.81,6,4,2
"4563",3280,3402.88,3247.52,-155.36,"increase",6650.4,2821,1485,1336
"4564",3336,7004.72,5023.47,-1981.25,"increase",12028.19,4417,2349,2068
"4565",3618,5163.03,4391.28,-771.75,"increase",9554.31,2995,1622,1373
"4566",630,11635.76,9542.21,-2093.55,"increase",21177.97,7486,4416,3070
"4567",649,3374.07,3339.54,-34.5300000000002,"increase",6713.61,3300,1676,1624
"4568",881,2367.25,2720.9,353.65,"increase",5088.15,1691,836,855
"4569",3848,3657.58,4094.87,437.29,"increase",7752.45,3989,1841,2148
"4570",1642,8738.25,8574.06,-164.190000000001,"increase",17312.31,6371,3267,3104
"4571",1363,8291.39,8997.06,705.67,"increase",17288.45,5951,2938,3013
"4572",2479,8.47,25.83,17.36,"increase",34.3,17,5,12
"4573",1073,11232.36,8247.23,-2985.13,"increase",19479.59,5387,3242,2145
"4574",2471,5500.86,4679.85,-821.009999999999,"increase",10180.71,4095,2195,1900
"4575",2525,1815.35,2359.75,544.4,"increase",4175.1,1496,643,853
"4576",3112,1960.41,2269.29,308.88,"increase",4229.7,1564,770,794
"4577",3131,2948.17,2715.54,-232.63,"increase",5663.71,2356,1232,1124
"4578",3239,83.93,0,-83.93,"increase",83.93,31,31,0
"4579",3520,4574.77,4538.35,-36.4200000000001,"increase",9113.12,2765,1356,1409
"4580",484,3511.56,4586.82,1075.26,"increase",8098.38,2594,1207,1387
"4581",2413,0,82.92,82.92,"increase",82.92,24,0,24
"4582",2964,4.69,0,-4.69,"increase",4.69,3,3,0
"4583",3068,6024.91,7326.86,1301.95,"increase",13351.77,4154,1885,2269
"4584",1281,9315.78,8315.71,-1000.07,"increase",17631.49,5234,2738,2496
"4585",21,1771.17,1743.2,-27.97,"increase",3514.37,1631,805,826
"4586",564,2474.65,3988.05,1513.4,"increase",6462.7,2738,1132,1606
"4587",655,5111.34,4239.77,-871.57,"increase",9351.11,4014,2239,1775
"4588",957,1884.11,1462.49,-421.62,"increase",3346.6,1289,712,577
"4589",2102,4604.49,3908.23,-696.26,"increase",8512.72,2932,1615,1317
"4590",2307,4764.79,8563.02,3798.23,"increase",13327.81,3703,1352,2351
"4591",2708,5063.75,7158.9,2095.15,"increase",12222.65,2464,1089,1375
"4592",4037,2,0,-2,"increase",2,1,1,0
"4593",2739,2839.19,3528.69,689.5,"increase",6367.88,3091,1416,1675
"4594",3972,5489.85,5391.63,-98.2200000000003,"increase",10881.48,4026,2055,1971
"4595",192,3328.47,3739.52,411.05,"increase",7067.99,2665,1236,1429
"4596",3406,4175.58,4386.48,210.900000000001,"increase",8562.06,3316,1673,1643
"4597",347,5824.81,9957.2,4132.39,"increase",15782.01,7321,2829,4492
"4598",1153,4825.64,4132.2,-693.440000000001,"increase",8957.84,3596,1956,1640
"4599",1799,9.27,0,-9.27,"increase",9.27,3,3,0
"4600",4907,278.57,233.16,-45.41,"increase",511.73,178,114,64
"4601",313,0,21.9,21.9,"increase",21.9,9,0,9
"4602",1356,6875.34,8475.72,1600.38,"increase",15351.06,5142,2241,2901
"4603",2070,12478.13,13575.16,1097.03,"increase",26053.29,11197,5390,5807
"4604",2082,4804.95,5280.11,475.16,"increase",10085.06,6003,2968,3035
"4605",2443,260.36,0,-260.36,"increase",260.36,59,59,0
"4606",3930,248.55,0,-248.55,"increase",248.55,56,56,0
"4607",4649,2779.39,3641.27,861.88,"increase",6420.66,2791,1236,1555
"4608",561,6871.38,4780.71,-2090.67,"increase",11652.09,3107,1810,1297
"4609",415,992.25,915.15,-77.1,"increase",1907.4,833,410,423
"4610",2023,2681,2693.44,12.4400000000001,"increase",5374.44,3322,1567,1755
"4611",61,27.48,173.04,145.56,"increase",200.52,15,2,13
"4612",129,2882.43,2394.23,-488.2,"increase",5276.66,1973,1113,860
"4613",144,8825.44,6611.44,-2214,"increase",15436.88,4791,2661,2130
"4614",368,53.02,3.98,-49.04,"increase",57,16,15,1
"4615",393,0,99.59,99.59,"increase",99.59,35,0,35
"4616",944,14054.81,13546.65,-508.16,"increase",27601.46,8837,4719,4118
"4617",1169,11696.49,9775.94,-1920.55,"increase",21472.43,6351,3468,2883
"4618",1432,11344.13,10175.31,-1168.82,"increase",21519.44,5572,2903,2669
"4619",1647,4435.34,3199.11,-1236.23,"increase",7634.45,3293,1957,1336
"4620",1694,8755.57,9344.44,588.870000000001,"increase",18100.01,7013,3445,3568
"4621",2416,0,78.17,78.17,"increase",78.17,16,0,16
"4622",4074,3.54,0,-3.54,"increase",3.54,6,6,0
"4623",4472,6103.85,5486.81,-617.04,"increase",11590.66,3671,1840,1831
"4624",4621,0,149.11,149.11,"increase",149.11,42,0,42
"4625",4852,20.92,30.38,9.46,"increase",51.3,13,9,4
"4626",189,5144.8,7148.77,2003.97,"increase",12293.57,3833,1703,2130
"4627",988,2424.2,2465.42,41.2200000000003,"increase",4889.62,1655,846,809
"4628",992,4490.93,5108.02,617.09,"increase",9598.95,4367,2038,2329
"4629",1185,7829.76,7137.77,-691.99,"increase",14967.53,5937,3052,2885
"4630",1311,9879.93,7690.41,-2189.52,"increase",17570.34,7592,4078,3514
"4631",1334,8441.55,10060.16,1618.61,"increase",18501.71,8150,3957,4193
"4632",1749,8208.63,7618.19,-590.440000000001,"increase",15826.82,7595,3942,3653
"4633",1818,6819.11,8539.94,1720.83,"increase",15359.05,4016,1809,2207
"4634",2221,3769.96,3788.49,18.5300000000002,"increase",7558.45,3047,1517,1530
"4635",2497,8.5,0,-8.5,"increase",8.5,7,7,0
"4636",2820,12734.65,10910.1,-1824.55,"increase",23644.75,8697,4730,3967
"4637",2836,5328.3,9236.37,3908.07,"increase",14564.67,7284,2326,4958
"4638",3100,113.35,0,-113.35,"increase",113.35,44,44,0
"4639",3708,4978.95,5222.01,243.06,"increase",10200.96,5304,2444,2860
"4640",3808,5661.5,5283.33,-378.17,"increase",10944.83,4908,2533,2375
"4641",4012,25.49,5.93,-19.56,"increase",31.42,9,6,3
"4642",4081,5485.03,4782.97,-702.059999999999,"increase",10268,2422,1302,1120
"4643",4109,1284.19,1448.69,164.5,"increase",2732.88,1378,577,801
"4644",4182,5854.76,6374.81,520.05,"increase",12229.57,4263,1940,2323
"4645",4530,3819.54,7716.28,3896.74,"increase",11535.82,4543,1571,2972
"4646",4558,5047.44,5669.75,622.309999999999,"increase",10717.19,5559,2609,2950
"4647",4855,2925.43,3113.29,187.86,"increase",6038.72,1590,716,874
"4648",122,162.73,1053.93,891.2,"increase",1216.66,396,68,328
"4649",188,29.29,0,-29.29,"increase",29.29,22,22,0
"4650",468,171.96,636.93,464.97,"increase",808.89,370,76,294
"4651",602,2269.41,2261.73,-7.67999999999984,"increase",4531.14,1564,800,764
"4652",686,8886.08,5970.3,-2915.78,"increase",14856.38,4711,2859,1852
"4653",796,7972.7,6886.25,-1086.45,"increase",14858.95,4896,2602,2294
"4654",838,4487.33,6715.01,2227.68,"increase",11202.34,3798,1572,2226
"4655",1219,6547.74,5975.14,-572.599999999999,"increase",12522.88,4631,2483,2148
"4656",1234,10430.34,9439.22,-991.120000000001,"increase",19869.56,6706,3580,3126
"4657",1279,3138.68,3842.09,703.41,"increase",6980.77,4021,1941,2080
"4658",1563,8606.35,8383.78,-222.57,"increase",16990.13,6020,3096,2924
"4659",1876,11946.99,12180.51,233.52,"increase",24127.5,5903,2720,3183
"4660",2109,5196.47,6035.93,839.46,"increase",11232.4,3972,1887,2085
"4661",2937,6487.61,4612.67,-1874.94,"increase",11100.28,3655,2207,1448
"4662",3363,2086.51,3101.61,1015.1,"increase",5188.12,1720,678,1042
"4663",3576,2694.71,4052.98,1358.27,"increase",6747.69,2302,850,1452
"4664",3580,8329.02,8056.08,-272.940000000001,"increase",16385.1,6643,3345,3298
"4665",3605,0,6.27,6.27,"increase",6.27,3,0,3
"4666",3656,5683.21,5335.59,-347.62,"increase",11018.8,3503,1768,1735
"4667",3874,16.16,210.26,194.1,"increase",226.42,26,4,22
"4668",3890,755.11,892.08,136.97,"increase",1647.19,657,281,376
"4669",3900,8726.56,7334.92,-1391.64,"increase",16061.48,4392,2351,2041
"4670",3971,9349.74,9666.88,317.140000000001,"increase",19016.62,5473,2658,2815
"4671",4007,9131.85,7900.99,-1230.86,"increase",17032.84,5285,2898,2387
"4672",4014,13.83,0,-13.83,"increase",13.83,7,7,0
"4673",4132,106.74,50.17,-56.57,"increase",156.91,29,19,10
"4674",4302,4285.01,3546.02,-738.99,"increase",7831.03,3159,1761,1398
"4675",4979,2670.05,5698.49,3028.44,"increase",8368.54,3498,1107,2391
"4676",338,8252.12,8352.01,99.8899999999994,"increase",16604.13,4594,2474,2120
"4677",406,0,246.36,246.36,"increase",246.36,59,0,59
"4678",727,5802.8,5241.96,-560.84,"increase",11044.76,3115,1656,1459
"4679",993,1601.66,1452.23,-149.43,"increase",3053.89,932,493,439
"4680",1355,21358.7,19986.1,-1372.6,"increase",41344.8,15108,7710,7398
"4681",1364,4485.71,4952.87,467.16,"increase",9438.58,5599,2673,2926
"4682",1918,16473.85,16499.42,25.5700000000033,"increase",32973.27,9007,4587,4420
"4683",2153,3881.13,7138.08,3256.95,"increase",11019.21,4169,1476,2693
"4684",2434,46,131.16,85.16,"increase",177.16,60,21,39
"4685",2435,53.95,240.64,186.69,"increase",294.59,106,17,89
"4686",2557,0,28.44,28.44,"increase",28.44,6,0,6
"4687",2654,2110.32,3159.73,1049.41,"increase",5270.05,1492,588,904
"4688",3343,3157.64,3303.19,145.55,"increase",6460.83,2534,1215,1319
"4689",3347,2649.65,2083.9,-565.75,"increase",4733.55,1865,1096,769
"4690",3435,3519.96,4914.88,1394.92,"increase",8434.84,2781,1159,1622
"4691",3783,4560.73,4675.11,114.379999999999,"increase",9235.84,3841,1823,2018
"4692",4060,11122.3,9190.8,-1931.5,"increase",20313.1,7215,3912,3303
"4693",4208,7071.23,3332.45,-3738.78,"increase",10403.68,3166,2091,1075
"4694",4681,696.85,1393.52,696.67,"increase",2090.37,703,224,479
"4695",17,7246.95,9422.96,2176.01,"increase",16669.91,7542,3480,4062
"4696",23,7072.8,5314.72,-1758.08,"increase",12387.52,4465,2526,1939
"4697",38,13931.36,16104.59,2173.23,"increase",30035.95,10434,4849,5585
"4698",258,5046.17,4353.97,-692.2,"increase",9400.14,3702,2025,1677
"4699",360,18.49,0,-18.49,"increase",18.49,1,1,0
"4700",367,97.65,8.28,-89.37,"increase",105.93,28,24,4
"4701",648,4236.4,5284.68,1048.28,"increase",9521.08,3204,1470,1734
"4702",828,9258.55,8557.11,-701.439999999999,"increase",17815.66,7012,3737,3275
"4703",897,6971.68,5547.64,-1424.04,"increase",12519.32,4868,2620,2248
"4704",954,5535.75,5378.16,-157.59,"increase",10913.91,3200,1658,1542
"4705",1262,9203.33,10097.43,894.1,"increase",19300.76,6040,3029,3011
"4706",1271,7865.22,7980.95,115.73,"increase",15846.17,6581,3184,3397
"4707",1558,4374.49,5901.47,1526.98,"increase",10275.96,3067,1259,1808
"4708",1702,5141.65,5843.06,701.410000000001,"increase",10984.71,3753,1855,1898
"4709",1910,0,9.99,9.99,"increase",9.99,1,0,1
"4710",2007,8162.75,7307.64,-855.11,"increase",15470.39,5003,2636,2367
"4711",2206,4803.36,5278.55,475.190000000001,"increase",10081.91,4745,2342,2403
"4712",2366,5011.91,5573.29,561.38,"increase",10585.2,4258,2141,2117
"4713",2679,3868,4375.28,507.28,"increase",8243.28,1945,968,977
"4714",2689,9916.38,8640.4,-1275.98,"increase",18556.78,7614,3988,3626
"4715",3234,0,326.8,326.8,"increase",326.8,120,0,120
"4716",3282,6042.34,7142,1099.66,"increase",13184.34,4185,2019,2166
"4717",3462,6999.72,4954.58,-2045.14,"increase",11954.3,4208,2557,1651
"4718",3685,7722.04,7172.26,-549.78,"increase",14894.3,4782,2524,2258
"4719",4108,53.9,0,-53.9,"increase",53.9,11,11,0
"4720",4329,3811.77,4440.15,628.38,"increase",8251.92,2665,1244,1421
"4721",4489,141.16,0,-141.16,"increase",141.16,34,34,0
"4722",54,3.49,23.77,20.28,"increase",27.26,5,2,3
"4723",85,4716.33,1726.12,-2990.21,"increase",6442.45,1835,1311,524
"4724",590,9165.18,8886.29,-278.889999999999,"increase",18051.47,6332,3431,2901
"4725",724,2675.6,1812.12,-863.48,"increase",4487.72,1807,1078,729
"4726",903,4869.13,6899.6,2030.47,"increase",11768.73,4027,1613,2414
"4727",1992,82.84,0,-82.84,"increase",82.84,55,55,0
"4728",3400,2481.09,1496.72,-984.37,"increase",3977.81,1609,1054,555
"4729",3603,3518.01,3696.41,178.4,"increase",7214.42,3409,1637,1772
"4730",3997,6338.46,5625.83,-712.63,"increase",11964.29,5155,2550,2605
"4731",4245,10931.89,9060.78,-1871.11,"increase",19992.67,6016,3184,2832
"4732",2,8610.03,8446.22,-163.810000000001,"increase",17056.25,5314,2666,2648
"4733",60,19269.23,22753.15,3483.92,"increase",42022.38,11090,4995,6095
"4734",171,10931.57,10475.19,-456.379999999999,"increase",21406.76,6813,3600,3213
"4735",329,4235.07,3720.95,-514.12,"increase",7956.02,2161,1153,1008
"4736",708,14577.55,17118.22,2540.67,"increase",31695.77,9842,4647,5195
"4737",874,4931.67,4903.29,-28.3800000000001,"increase",9834.96,3278,1736,1542
"4738",886,7765.69,7549.93,-215.76,"increase",15315.62,5249,2700,2549
"4739",1042,9682.03,9344.1,-337.93,"increase",19026.13,5903,3017,2886
"4740",1076,0,14.97,14.97,"increase",14.97,10,0,10
"4741",1425,10678.71,11216.68,537.969999999999,"increase",21895.39,9438,4695,4743
"4742",1528,8497.31,2674.97,-5822.34,"increase",11172.28,3137,2462,675
"4743",1914,134.13,135.16,1.03,"increase",269.29,92,53,39
"4744",2174,0,186.24,186.24,"increase",186.24,49,0,49
"4745",3030,10055.5,11991.94,1936.44,"increase",22047.44,5828,2641,3187
"4746",3089,5780.99,5992.2,211.21,"increase",11773.19,3789,1888,1901
"4747",3102,0,69.21,69.21,"increase",69.21,24,0,24
"4748",3113,4045.86,4006.24,-39.6199999999999,"increase",8052.1,3427,1759,1668
"4749",3128,12.48,0,-12.48,"increase",12.48,2,2,0
"4750",3133,4720.06,4230.62,-489.440000000001,"increase",8950.68,1937,1072,865
"4751",3149,7169.43,6148.16,-1021.27,"increase",13317.59,4094,2195,1899
"4752",3185,0,80.88,80.88,"increase",80.88,19,0,19
"4753",3213,16846.26,16691.36,-154.900000000001,"increase",33537.62,9508,4874,4634
"4754",3313,0,1.99,1.99,"increase",1.99,3,0,3
"4755",3382,4315.17,5263.68,948.51,"increase",9578.85,3539,1384,2155
"4756",3515,1114.7,723.55,-391.15,"increase",1838.25,671,403,268
"4757",3873,8315.34,10017.61,1702.27,"increase",18332.95,5493,2594,2899
"4758",3892,16.85,0,-16.85,"increase",16.85,4,4,0
"4759",3905,6.38,0,-6.38,"increase",6.38,3,3,0
"4760",4094,25.64,18.99,-6.65,"increase",44.63,10,6,4
"4761",4179,0,29.49,29.49,"increase",29.49,9,0,9
"4762",4196,7628.65,7013.51,-615.14,"increase",14642.16,4388,2286,2102
"4763",4254,7953.76,9290.55,1336.79,"increase",17244.31,6339,3032,3307
"4764",4312,15898.02,9010.38,-6887.64,"increase",24908.4,5991,3806,2185
"4765",4914,4690.46,5597.11,906.65,"increase",10287.57,4003,1897,2106
"4766",111,7195.78,6440.54,-755.24,"increase",13636.32,4804,2484,2320
"4767",118,1218.24,1666.91,448.67,"increase",2885.15,1124,487,637
"4768",286,8.48,0,-8.48,"increase",8.48,4,4,0
"4769",878,30.54,25.98,-4.56,"increase",56.52,10,6,4
"4770",975,3362.35,5392.81,2030.46,"increase",8755.16,2896,1022,1874
"4771",1188,9786.64,10131.51,344.870000000001,"increase",19918.15,6648,3212,3436
"4772",1249,10418.8,13462.49,3043.69,"increase",23881.29,7334,3436,3898
"4773",1315,8330.01,8652.32,322.309999999999,"increase",16982.33,6309,3096,3213
"4774",1434,9.05,135.81,126.76,"increase",144.86,56,4,52
"4775",1968,1688.49,5145.23,3456.74,"increase",6833.72,1924,472,1452
"4776",2262,6045.98,2408.31,-3637.67,"increase",8454.29,3054,2169,885
"4777",2405,1192.65,1530.04,337.39,"increase",2722.69,1858,936,922
"4778",2872,9396.97,10614.49,1217.52,"increase",20011.46,9054,4199,4855
"4779",2878,10358.83,11773.61,1414.78,"increase",22132.44,7461,3525,3936
"4780",2991,9165.64,9474.56,308.92,"increase",18640.2,5099,2665,2434
"4781",3124,48.05,0,-48.05,"increase",48.05,12,12,0
"4782",3247,12731.45,12020.97,-710.480000000001,"increase",24752.42,10689,5406,5283
"4783",3512,3476.64,4911.66,1435.02,"increase",8388.3,4281,1888,2393
"4784",3669,1601.94,2276.46,674.52,"increase",3878.4,1361,571,790
"4785",3670,6103.48,6303.48,200,"increase",12406.96,6028,3051,2977
"4786",3694,0,9.7,9.7,"increase",9.7,13,0,13
"4787",3824,95.23,0,-95.23,"increase",95.23,32,32,0
"4788",4073,2143.77,2419.18,275.41,"increase",4562.95,1362,586,776
"4789",4086,4634.75,2399.76,-2234.99,"increase",7034.51,2823,1872,951
"4790",4166,5912.96,6135.24,222.28,"increase",12048.2,3708,1798,1910
"4791",4559,0,1.99,1.99,"increase",1.99,1,0,1
"4792",200,2497.69,2980.68,482.99,"increase",5478.37,2708,1229,1479
"4793",332,5712.94,5236.1,-476.84,"increase",10949.04,4706,2442,2264
"4794",423,3737.66,4350.87,613.21,"increase",8088.53,3311,1554,1757
"4795",512,6332.18,6353.59,21.4099999999999,"increase",12685.77,4030,1996,2034
"4796",547,2.79,0,-2.79,"increase",2.79,1,1,0
"4797",657,1168.07,19.34,-1148.73,"increase",1187.41,344,338,6
"4798",706,11441.81,9697.47,-1744.34,"increase",21139.28,7229,3912,3317
"4799",919,4835.5,3960.5,-875,"increase",8796,2911,1666,1245
"4800",920,4835.5,3960.5,-875,"increase",8796,2911,1666,1245
"4801",1033,6179.08,4008.57,-2170.51,"increase",10187.65,4864,2842,2022
"4802",1132,38.34,0,-38.34,"increase",38.34,11,11,0
"4803",1270,13813.03,15019.87,1206.84,"increase",28832.9,10382,5391,4991
"4804",1342,4664.93,4676.92,11.9899999999998,"increase",9341.85,2822,1399,1423
"4805",1419,1892.73,2717.94,825.21,"increase",4610.67,1677,690,987
"4806",1706,8597.72,7802.68,-795.039999999999,"increase",16400.4,5266,2861,2405
"4807",1759,3403.72,3424.02,20.2999999999997,"increase",6827.74,3039,1534,1505
"4808",1817,61.37,135.77,74.4,"increase",197.14,77,23,54
"4809",2063,4358.53,5859.21,1500.68,"increase",10217.74,3542,1556,1986
"4810",2359,0,113.87,113.87,"increase",113.87,57,0,57
"4811",2848,6149.74,6221.73,71.9900000000007,"increase",12371.47,7267,3637,3630
"4812",2904,5182.97,5484.9,301.93,"increase",10667.87,4458,2195,2263
"4813",3196,4755.16,5769.23,1014.07,"increase",10524.39,3413,1431,1982
"4814",3200,13041.16,12495.05,-546.109999999999,"increase",25536.21,8067,4139,3928
"4815",3389,6964.36,4266.79,-2697.57,"increase",11231.15,3970,2416,1554
"4816",3449,4921.13,4744.52,-176.61,"increase",9665.65,3849,1964,1885
"4817",3570,7.98,259.78,251.8,"increase",267.76,73,2,71
"4818",3829,5174.26,5819.42,645.16,"increase",10993.68,4527,2119,2408
"4819",3872,3327.25,3420.4,93.1500000000001,"increase",6747.65,3329,1601,1728
"4820",3904,1300.62,1491.36,190.74,"increase",2791.98,1879,813,1066
"4821",4087,3941.94,4262.89,320.95,"increase",8204.83,2754,1395,1359
"4822",4129,0,2.49,2.49,"increase",2.49,1,0,1
"4823",4365,2915.38,2923.52,8.13999999999987,"increase",5838.9,2212,1168,1044
"4824",4832,5.18,0,-5.18,"increase",5.18,2,2,0
"4825",18,3310.14,2553.88,-756.26,"increase",5864.02,2975,1697,1278
"4826",63,8586.16,11488.54,2902.38,"increase",20074.7,7855,3715,4140
"4827",79,7607.82,7351.34,-256.48,"increase",14959.16,5407,2699,2708
"4828",110,5313.01,5200.91,-112.1,"increase",10513.92,3639,1829,1810
"4829",296,6895.43,7926.07,1030.64,"increase",14821.5,4769,2317,2452
"4830",319,4156.49,4618.07,461.58,"increase",8774.56,2656,1188,1468
"4831",348,0,17.77,17.77,"increase",17.77,5,0,5
"4832",371,9232.51,8717.61,-514.9,"increase",17950.12,5027,2415,2612
"4833",426,40.72,0,-40.72,"increase",40.72,18,18,0
"4834",436,233.63,1321.6,1087.97,"increase",1555.23,696,149,547
"4835",531,5340.44,4089.23,-1251.21,"increase",9429.67,5301,3110,2191
"4836",607,4720.01,4848.78,128.77,"increase",9568.79,3517,1725,1792
"4837",915,1851.4,1962.14,110.74,"increase",3813.54,1368,683,685
"4838",1222,11032.02,12327.71,1295.69,"increase",23359.73,7603,3671,3932
"4839",1328,4012.04,4460.41,448.37,"increase",8472.45,3157,1580,1577
"4840",1330,5637.89,5128.75,-509.14,"increase",10766.64,6693,3447,3246
"4841",1353,5769.08,3271.18,-2497.9,"increase",9040.26,2960,1925,1035
"4842",1407,7662.08,7870.22,208.14,"increase",15532.3,5692,2959,2733
"4843",1572,13032.11,12990.53,-41.5799999999999,"increase",26022.64,8205,4110,4095
"4844",1691,6994.74,10911.29,3916.55,"increase",17906.03,7133,2973,4160
"4845",1961,6951.43,5931.14,-1020.29,"increase",12882.57,3443,1915,1528
"4846",2211,9147.88,13451.91,4304.03,"increase",22599.79,6545,2481,4064
"4847",2275,7232.49,9658.58,2426.09,"increase",16891.07,5693,2460,3233
"4848",2361,4024.86,4720.14,695.28,"increase",8745,4269,1971,2298
"4849",2453,679.08,0,-679.08,"increase",679.08,214,214,0
"4850",2521,9404.33,9954.17,549.84,"increase",19358.5,6642,3161,3481
"4851",2549,3054.4,2069.92,-984.48,"increase",5124.32,2542,1391,1151
"4852",2688,1999.54,1134.5,-865.04,"increase",3134.04,2463,1442,1021
"4853",2703,1987.48,3496.4,1508.92,"increase",5483.88,1764,740,1024
"4854",2728,8844.21,8996.75,152.539999999999,"increase",17840.96,6776,3358,3418
"4855",2807,5250.03,4928.98,-321.049999999999,"increase",10179.01,2376,1120,1256
"4856",3161,2.37,0,-2.37,"increase",2.37,1,1,0
"4857",3233,332.32,21.93,-310.39,"increase",354.25,125,116,9
"4858",3306,5930.83,4101.67,-1829.16,"increase",10032.5,3542,1999,1543
"4859",3356,7892.27,8965.94,1073.67,"increase",16858.21,8240,4002,4238
"4860",3372,0,6.79,6.79,"increase",6.79,2,0,2
"4861",3574,5830.91,5233.78,-597.13,"increase",11064.69,5929,2955,2974
"4862",3649,3938.62,3686.73,-251.89,"increase",7625.35,3072,1549,1523
"4863",3693,39.98,60.73,20.75,"increase",100.71,7,2,5
"4864",3702,7610.16,8275.23,665.07,"increase",15885.39,4133,2025,2108
"4865",3773,7061.5,7802.41,740.91,"increase",14863.91,4803,2253,2550
"4866",3801,99.02,0,-99.02,"increase",99.02,49,49,0
"4867",3840,0,14.47,14.47,"increase",14.47,3,0,3
"4868",3843,8849.39,10262.81,1413.42,"increase",19112.2,6793,3173,3620
"4869",3993,72.7,38.81,-33.89,"increase",111.51,31,18,13
"4870",4018,0,96.92,96.92,"increase",96.92,18,0,18
"4871",9,0,25.97,25.97,"increase",25.97,3,0,3
"4872",16,245.11,6,-239.11,"increase",251.11,73,69,4
"4873",87,1759.35,2595.62,836.27,"increase",4354.97,1623,727,896
"4874",101,3449.7,2956.22,-493.48,"increase",6405.92,2206,1195,1011
"4875",108,7726.94,12647.16,4920.22,"increase",20374.1,5862,2356,3506
"4876",178,6938.53,7195.42,256.89,"increase",14133.95,5385,2647,2738
"4877",217,10350.55,11804.75,1454.2,"increase",22155.3,4984,2409,2575
"4878",223,128.11,5.79,-122.32,"increase",133.9,31,28,3
"4879",239,0,307.15,307.15,"increase",307.15,100,0,100
"4880",242,0,103.77,103.77,"increase",103.77,34,0,34
"4881",243,0,224.85,224.85,"increase",224.85,56,0,56
"4882",505,9304.67,8549.04,-755.629999999999,"increase",17853.71,6810,3593,3217
"4883",526,62.71,68.62,5.91,"increase",131.33,36,20,16
"4884",580,10639.61,11182.38,542.77,"increase",21821.99,8126,4071,4055
"4885",672,4337.74,3414.41,-923.33,"increase",7752.15,2749,1580,1169
"4886",673,4337.74,3414.41,-923.33,"increase",7752.15,2749,1580,1169
"4887",742,5539.82,5564.29,24.4700000000003,"increase",11104.11,3795,1875,1920
"4888",794,6760.92,7112.27,351.35,"increase",13873.19,4112,2133,1979
"4889",949,5759.02,6564.99,805.969999999999,"increase",12324.01,5023,2373,2650
"4890",958,3346.97,3598.21,251.24,"increase",6945.18,3222,1681,1541
"4891",1077,36.63,59.22,22.59,"increase",95.85,22,12,10
"4892",1162,4430.18,6592.63,2162.45,"increase",11022.81,4715,2054,2661
"4893",1178,3782.82,527.08,-3255.74,"increase",4309.9,1847,1646,201
"4894",1228,8467.91,8912,444.09,"increase",17379.91,7143,3507,3636
"4895",1312,9068.89,10510.51,1441.62,"increase",19579.4,5968,2861,3107
"4896",1428,4255.01,4067.11,-187.9,"increase",8322.12,2613,1322,1291
"4897",1437,3664.48,4251.69,587.21,"increase",7916.17,3486,1635,1851
"4898",1551,13621.65,12736.66,-884.99,"increase",26358.31,9333,4882,4451
"4899",1845,5060.26,5059.25,-1.01000000000022,"increase",10119.51,3463,1759,1704
"4900",2013,5145.54,2705.1,-2440.44,"increase",7850.64,2286,1506,780
"4901",2473,3526.84,5266.26,1739.42,"increase",8793.1,2976,1113,1863
"4902",2646,2833.35,2719.69,-113.66,"increase",5553.04,1833,883,950
"4903",2827,6434.35,6654.5,220.15,"increase",13088.85,4757,2452,2305
"4904",2921,4.19,0,-4.19,"increase",4.19,3,3,0
"4905",2946,9947.69,12630.68,2682.99,"increase",22578.37,8232,3664,4568
"4906",3086,130.63,203.3,72.67,"increase",333.93,108,46,62
"4907",3243,0,2,2,"increase",2,2,0,2
"4908",3267,816.5,0,-816.5,"increase",816.5,202,202,0
"4909",3374,118.22,0,-118.22,"increase",118.22,36,36,0
"4910",3396,9330.53,7285.86,-2044.67,"increase",16616.39,3218,1770,1448
"4911",3709,11535.51,12071.06,535.549999999999,"increase",23606.57,8170,4154,4016
"4912",3842,7893.11,7936.22,43.1100000000006,"increase",15829.33,5326,2589,2737
"4913",3851,2.5,0,-2.5,"increase",2.5,1,1,0
"4914",3923,3247.84,3387.69,139.85,"increase",6635.53,2549,1278,1271
"4915",3924,4762.69,4751.76,-10.9300000000003,"increase",9514.45,3023,1576,1447
"4916",3925,6820.41,7451.44,631.030000000001,"increase",14271.85,3808,1841,1967
"4917",3934,12601.72,11790.48,-811.24,"increase",24392.2,6146,3375,2771
"4918",3983,0,99.47,99.47,"increase",99.47,44,0,44
"4919",4091,7373.05,7230.63,-142.42,"increase",14603.68,4461,2379,2082
"4920",4189,4975.1,4219.54,-755.56,"increase",9194.64,2953,1642,1311
"4921",4223,1351.84,854.57,-497.27,"increase",2206.41,1135,697,438
"4922",4478,29.61,0,-29.61,"increase",29.61,12,12,0
"4923",4575,11490.67,11031.59,-459.08,"increase",22522.26,6223,3279,2944
"4924",4667,3238.97,4509.97,1271,"increase",7748.94,2209,840,1369
"4925",4821,8003.35,5715.08,-2288.27,"increase",13718.43,3567,2092,1475
"4926",234,5.49,0,-5.49,"increase",5.49,3,3,0
"4927",620,3402.85,3692.34,289.49,"increase",7095.19,3419,1760,1659
"4928",826,6167.12,6734.71,567.59,"increase",12901.83,4937,2336,2601
"4929",830,4987.01,3984.88,-1002.13,"increase",8971.89,4384,2415,1969
"4930",1066,0,7.79,7.79,"increase",7.79,1,0,1
"4931",1242,7256.74,7453.58,196.84,"increase",14710.32,7634,3775,3859
"4932",1856,10558.26,7857.64,-2700.62,"increase",18415.9,8630,4896,3734
"4933",2234,7129.24,7221.44,92.2000000000007,"increase",14350.68,6947,3447,3500
"4934",2367,4878.73,5190.73,312,"increase",10069.46,4864,2353,2511
"4935",2838,3743.06,5042.66,1299.6,"increase",8785.72,3700,1565,2135
"4936",4061,101.95,49.32,-52.63,"increase",151.27,86,64,22
"4937",4064,3911.5,4401.83,490.33,"increase",8313.33,3238,1532,1706
"4938",3253,8187.5,8734.05,546.549999999999,"increase",16921.55,5275,2576,2699
"4939",3278,0,4.55,4.55,"increase",4.55,4,0,4
"4940",3552,5141.2,6584.97,1443.77,"increase",11726.17,3589,1515,2074
"4941",4025,136.81,23.21,-113.6,"increase",160.02,48,37,11
"4942",11,79.88,177.28,97.4,"increase",257.16,76,16,60
"4943",308,4603.84,6098.7,1494.86,"increase",10702.54,4520,1886,2634
"4944",1053,361.59,195.47,-166.12,"increase",557.06,117,64,53
"4945",1275,3710.85,4715.66,1004.81,"increase",8426.51,3932,1756,2176
"4946",1522,3201.22,3264.08,62.8599999999997,"increase",6465.3,2791,1377,1414
"4947",2873,3496.12,3568.32,72.2000000000003,"increase",7064.44,3214,1626,1588
"4948",3154,5170.49,2413.11,-2757.38,"increase",7583.6,3188,2197,991
"4949",3775,4024.08,4033.02,8.94000000000005,"increase",8057.1,2833,1443,1390
"4950",3850,971.85,1612.2,640.35,"increase",2584.05,911,366,545
"4951",4144,5380.5,4891.85,-488.65,"increase",10272.35,3303,1661,1642
"4952",4433,3367.03,4141.6,774.57,"increase",7508.63,1972,849,1123
"4953",4517,9994.15,9533.37,-460.779999999999,"increase",19527.52,6729,3389,3340
"4954",112,8509.08,6698.4,-1810.68,"increase",15207.48,6031,3476,2555
"4955",2860,11072.33,11548.98,476.65,"increase",22621.31,6296,3097,3199
"4956",3944,4.57,13.85,9.28,"increase",18.42,12,3,9
"4957",3949,6425.42,7559.87,1134.45,"increase",13985.29,6509,3021,3488
"4958",4070,3153.07,2696.72,-456.35,"increase",5849.79,1483,790,693
"4959",4748,5596.85,4842.11,-754.740000000001,"increase",10438.96,3535,1784,1751
"4960",4780,7307.47,7031.29,-276.18,"increase",14338.76,4680,2485,2195
"4961",4948,7593.92,11955.16,4361.24,"increase",19549.08,6477,2689,3788
"4962",4962,8,4.17,-3.83,"increase",12.17,5,3,2
"4963",917,11559.85,11762.32,202.469999999999,"increase",23322.17,9753,4955,4798
"4964",1766,12633.95,11049.69,-1584.26,"increase",23683.64,7031,3801,3230
"4965",2352,4767.4,5868.23,1100.83,"increase",10635.63,3447,1484,1963
"4966",2531,7495.19,7204.97,-290.22,"increase",14700.16,5745,2856,2889
"4967",2724,4299.5,3813.64,-485.86,"increase",8113.14,3716,1956,1760
"4968",3222,2990.04,3028.71,38.6700000000001,"increase",6018.75,2396,1209,1187
"4969",3469,3369.23,5412.42,2043.19,"increase",8781.65,4091,1445,2646
"4970",4085,9494.09,4966.56,-4527.53,"increase",14460.65,4662,3141,1521
"4971",4092,0,3.29,3.29,"increase",3.29,1,0,1
"4972",1233,9620.04,9768.47,148.429999999998,"increase",19388.51,6323,3107,3216
"4973",1321,5779.73,6770.05,990.32,"increase",12549.78,3601,1620,1981
"4974",1337,7912.85,6926.25,-986.6,"increase",14839.1,5121,2617,2504
"4975",1922,0,257.19,257.19,"increase",257.19,76,0,76
"4976",2577,8067.75,13202.84,5135.09,"increase",21270.59,4916,1939,2977
"4977",3167,4417.13,3979.06,-438.07,"increase",8396.19,2742,1415,1327
"4978",3340,6377.39,6320.06,-57.3299999999999,"increase",12697.45,3973,2253,1720
"4979",3550,1840.8,1782.7,-58.0999999999999,"increase",3623.5,1015,546,469
"4980",3627,0,3.68,3.68,"increase",3.68,2,0,2
"4981",3833,9385.72,8895.51,-490.209999999999,"increase",18281.23,5046,2562,2484
"4982",4054,6551.18,6810.58,259.4,"increase",13361.76,4248,1995,2253
"4983",1317,4532.61,3015.52,-1517.09,"increase",7548.13,3191,2081,1110
"4984",1756,8270.43,8133.97,-136.46,"increase",16404.4,5516,2874,2642
"4985",2032,2256.21,1653.89,-602.32,"increase",3910.1,1782,1012,770
"4986",3039,7086.74,4951.84,-2134.9,"increase",12038.58,4863,2940,1923
"4987",3895,86.72,48.5,-38.22,"increase",135.22,51,39,12
"4988",4047,2081.96,1933.87,-148.09,"increase",4015.83,1461,772,689
"4989",4059,0,37.62,37.62,"increase",37.62,25,0,25
"4990",2001,7763.22,7498.47,-264.75,"increase",15261.69,3870,2017,1853
"4991",3440,12119.42,9800.15,-2319.27,"increase",21919.57,5479,2887,2592
"4992",4084,1930.47,1742.77,-187.7,"increase",3673.24,1240,675,565
"4993",4547,7481.53,6972.15,-509.379999999999,"increase",14453.68,5713,2940,2773
"4994",241,0,43.05,43.05,"increase",43.05,29,0,29
"4995",1034,1795.81,1804.87,9.06000000000017,"increase",3600.68,1267,649,618
"4996",1947,2826.93,2349.61,-477.32,"increase",5176.54,2174,1259,915
"4997",2592,4271.03,4041.66,-229.37,"increase",8312.69,3127,1615,1512
"4998",2673,7452.65,5375.68,-2076.97,"increase",12828.33,4121,2554,1567
"4999",3285,4260.26,4458.3,198.04,"increase",8718.56,3753,1798,1955
"5000",3650,464.13,648.71,184.58,"increase",1112.84,373,144,229
